twee onder een kap woning=twee-onder-een-kapwoning
grote vissen eten de kleinen=grote vissen eten de kleine.
Heb nog een goede dag=Nog een geode dag gewenst
Blijft met mij in contact=blijf met mij in contact
broer en ik deelde de=broer en ik deelden
alles in een oplossing=alles-in-eenoplossing
cat hij zij n=hij zijn
jeugd van tegenwoordig willen=jeugd van tegenwoordig wil
de roze kussen is=het roze kussen is
De actrice vind het=De actrice vindt het
dames- en heren kleding=dames- en herenkleding
dat hij doet niets=dat hij niets doet
dames en heren kleding=dames- en herenkleding
Ik een schrikkeljaar heeft=In een schrikkeljaar heeft
nek aan nek race=nek-aan-nek-race
zo veel mo gelijk=zoveel mogelijk
va n he t=van het
laag bij de gronds=laag-bij-de-gronds
alles in een abonnement=alles-in-eenabonnement
m id de n=midden
lik op stuk beleid=lik-op-stukbeleid
alles of niets mentaliteit=alles-of-nietsmentaliteit
v oor zijn=voor zijn
In e en=In een
niet mee r=niet meer
wel een s=wel eens
da t deze=dat deze
die hi j=die hij
en v oor=en voor
en n iet=en niet
moe t worden=moet worden
w el eens=wel eens
door e en=door een
va n deze=van deze
het w as=het was
als hi j=als hij
voor zij n=voor zijn
de j aren=de jaren
hi j zich=hij zich
da t je=dat je
de meest e=de meeste
Bi j de=Bij de
te w orden=te worden
de tij d=de tijd
moet w orden=moet worden
Hi j was=Hij was
d ie op=die op
de v raag=de vraag
ik n iet=ik niet
w at de=wat de
d oor een=door een
volgen s de=volgens de
w orden de=worden de
niet me er=niet meer
n iet aan=niet aan
h ij het=hij het
to do lijst=to-dolijst	Spatiefout
v ij f=vijf
werk privé balans=werk-privébalans
er v oor=ervoor
woon - werkverkeer=woon-werkverkeer
de zelf de=dezelfde
signaal / ruisverhoudingen=signaal-ruisverhoudingen
to do lijstjes=to-dolijstjes
par tij en=partijen
woon- werk verkeer=woon-werkverkeer
woon / werkverkeer=woon-werkverkeer	Spatiefout
ge volg en=gevolgen
d en k=denk
ge meen te=gemeente	Vast een spatiefout
jeu de boulesbaan=jeu-de-boulesbaan	Spatiefout
doe het zelver=doe-het-zelver	Spatiefout
di e de=die de
om he t=om het
w as er=was er
da t ik=dat ik
die n iet=die niet
in d ie=in die
van zij n=van zijn
acht er de=achter de
al s de=als de
to do lijsten=to-dolijsten	Spatiefout
zij n voor=zijn voor
I k heb=Ik heb
M ij n=Mijn
bij voor beeld=bijvoorbeeld	Spatiefout
in situ sanering=in-situsanering	Spatiefout
doe het zelvers=doe-het-zelvers	Spatiefout
op mij n=op mijn
van d en=van den
zij n in=zijn in
de eerst e=de eerste
lang s de=langs de
zij n om=zijn om
j aar geleden=jaar geleden
zij n dat=zijn dat
ze n iet=ze niet
h ij een=hij een
h ij zich=hij zich
is g een=is geen
di e op=die op
te word en=te worden
word t de=wordt de
heef t het=heeft het
een ze er=een zeer
zij n als=zijn als
M aar de=Maar de
w aar het=waar het
d at ze=dat ze
verband me t=verband met
uit zij n=uit zijn
die tij d=die tijd
w orden door=worden door
d at er=dat er
da t er=dat er
da t ze=dat ze
geen enkel e=geen enkele
Bi j het=Bij het
d at hij=dat hij
in zij n=in zijn
he b ik=heb ik
Je heb t=Je hebt
hebben w ij=hebben wij
aan zij n=aan zijn
dit j aar=dit jaar
bij he t=bij het
je ei gen=je eigen
da t dit=dat dit
dat z ij=dat zij
met nam e=met name
da t in=dat in
ik da t=ik dat
word t het=wordt het
u it een=uit een
va n den=van den
ge v al=geval
een goed e=een goede
te zij n=te zijn
ik mij n=ik mijn
kan w orden=kan worden
I k vind=Ik vind
hi j met=hij met
zij n van=zijn van
word t een=wordt een
die me t=die met
zij n eigen=zijn eigen
op bas is=op basis
zijn va n=zijn van
kunnen w orden=kunnen worden
informatie o ver=informatie over
m aar een=maar een
da t men=dat men
te krijg en=te krijgen
hand va n=hand van
zij n dan=zijn dan
te do en=te doen
ik me t=ik met
dat m en=dat men
con tact en=contacten
v in den=vinden
volg en de=volgende
in gebreke stelling=ingebrekestelling
in pand geving=inpandgeving
al l een=alleen
inde plaats stelling=indeplaatsstelling
t ij d=tijd
in bewaring geving=inbewaringgeving
ping pong balletjes=pingpongballetjes
in bewaring neming=inbewaringneming
in bewaring stelling=inbewaringstelling
in bezit neming=inbezitneming
in bezit treding=inbezittreding
in deplaats stelling=indeplaatsstelling
in bedrijf stelling=inbedrijfstelling
in dienst stelling=indienststelling
in dienst treding=indiensttreding
in gebruik neming=ingebruikneming
m ij n=mijn
ter beschikking stelling=terbeschikkingstelling
in stand houding=instandhouding
tot stand koming=totstandkoming
of te wel=oftewel|of|ofwel
van kracht wording=vankrachtwording
te water lating=tewaterlating
code rood waarschuwingen=coderoodwaarschuwingen
van waarde verklaring=vanwaardeverklaring
in acht neming=inachtneming
te werk stelling=tewerkstelling
ter zijde stelling=terzijdestelling
ping pong bal=pingpongbal
ping pong balletje=pingpongballetje
buiten gebruik stelling=buitengebruikstelling
buiten bezit stelling=buitenbezitstelling
in verzuim stelling=inverzuimstelling
kun n en=kunnen
rock 'n roll=rock-'n-roll
waarde verhogende factor=waardeverhogende factor
all inclusive vakantie=all-inclusivevakantie
all inclusive deals=all-inclusivedeals
all inclusive deal=all-inclusivedeal
verborgen camera programma=verborgencameraprogramma
verborgen camera actie=verborgencamera-actie
up te graden=te upgraden|op te waarderen|bij te werken	Taalfout:
dames en herenkleding=dames- en herenkleding
anderhalve meter regel=anderhalvemeterregel
in een planeet=is een planeet
high performance computer=highpeformancecomputer
laagste prijs garantie=laagsteprijsgarantie
zei dacht ze=zei dat ze
reactie onze voorstellen=reactie op onze voorstellen
fototoestel werk niet=fototoestel werkt niet
Ik hebt iets=ik heb iets
n ie t=niet
in verzekering stelling=inverzekeringstelling
z ij n=zijn
mens en heugenis=mensenheugenis
ter zijde lating=terzijdelating
broodje aap verhalen=broodjeaapverhalen
op jaren stelling=opjarenstelling
onder hand stelling=onderhandstelling
alt ij d=altijd
Tweeduizend vijfhonderd negenendertig=Tweeduizendvijfhonderdnegenendertig
onder erf stelling=ondererfstelling
w or den=worden
instel ling en=instellingen
leef en werkritme=leef- en werkritme
leef en sportgewoonten=leef- en sportgewoonten
leef en voedingsstijl=leef- en voedingsstijl
plug and play=plugandplay
in beslag neming=inbeslagneming
vol gen de=volgende
f ij n=fijn
buiten gevolg stelling=buitengevolgstelling
buiten gevecht stelling=buitengevechtstelling
e in d=eind
in dienst neming=indienstneming
on der zoek=onderzoek
geschied en is=geschiedenis
tij d en=tijden
k ij k=kijk
uit sprak en=uitspraken
voor w aarden=voorwaarden
Zo n dag=Zondag
na t uur=natuur
w arm te=warmte
waar de n=waarden
aan ge geven=aangegeven
in beschuldiging stelling=inbeschuldigingstelling
w ij n=wijn
te n slotte=tenslotte
to do lijstje=to-dolijstje
social media omgeving=socialmediaomgeving
on der wijs=onderwijs
ge niet en=genieten
aan de el=aandeel
jul l ie=jullie
na de r=nader
zij n een=zijn een
over een komst=overeenkomst
voor kom en=voorkomen
t er echt=terecht
ver kiezing en=verkiezingen
d ie n=dien
in de plaatsstelling=indeplaatsstelling
meet and greet=meetandgreet
ter post bezorging=terpostbezorging
up to date=up-to-date
look and feel=lookandfeel
te boek stelling=teboekstelling
te koop stelling=tekoopstelling
op non actiefstelling=opnonactiefstelling
opnon actief stelling=opnonactiefstelling
ping pong ballen=pingpongballen
ter leen geving=terleengeving
pro gram ma=programma
te gelde making=tegeldemaking
onder curatele stelling=ondercuratelestelling
onder toezicht stelling=ondertoezichtstelling
ter inzage legging=terinzagelegging
ter dood brenging=terdoodbrenging
broodje aap verhaal=broodjeaapverhaal
in ontvangst neming=inontvangstneming
ten uitvoer legging=tenuitvoerlegging
ter hand stelling=terhandstelling
ten achter stelling=tenachterstelling
te laste legging=telastelegging
gel ij k=gelijk
de r de=derde
in hechtenis neming=inhechtenisneming
m en s=mens
ter dood veroordeling=terdoodveroordeling
code rood waarschuwing=coderoodwaarschuwing
ter aarde bestelling=teraardebestelling
ter hand neming=terhandneming
ten uitvoer brenging=tenuitvoerbrenging
ten hemel opneming=tenhemelopneming
te naam stelling=tenaamstelling
in gebruik treding=ingebruiktreding
zij n die=zijn die
waar on der=waaronder
en toe n=en toen
da t een=dat een
me t zijn=met zijn
e en van=een van
d at is=dat is
n iet in=niet in
al s het=als het
dat e en=dat een
ui t te=uit te
met zij n=met zijn
zij n ogen=zijn ogen
in geplant om=ingepland om
is mij n=is mijn
te breng en=te brengen
nog e en=nog een
n iet te=niet te
ik mi j=ik mij
b ij een=bij een
niet alle en=niet alleen
He t zou=Het zou
dat he t=dat het
Ik b en=Ik ben
da t het=dat het
en he t=en het
mij n eigen=mijn eigen
He t was=Het was
naar mij n=naar mijn
bij mij n=bij mijn
te gebruik en=te gebruiken
zal w orden=zal worden
is echt er=is echter
w ij de=wij de
per j aar=per jaar
zij n, maar=zijn, maar
is n iet=is niet
ku n je=kun je
b ij de=bij de
en di e=en die
en zij n=en zijn
met e en=met een
ik h eb=ik heb
alle en in=alleen in
van e en=van een
al zij n=al zijn
van mij n=van mijn
de nieuw e=de nieuwe
zij n bij=zijn bij
te zoek en=te zoeken
b en ik=ben ik
Er zij n=Er zijn
er niet s=er niets
me t een=met een
van di t=van dit
m aar dat=maar dat
m eer dan=meer dan
w as het=was het
meer da n=meer dan
mee r dan=meer dan
te mak en=te maken
he t is=het is
te m aken=te maken
w aar de=waar de
e en aantal=een aantal
of e en=of een
de ander e=de andere
te g aan=te gaan
s amen met=samen met
ui t het=uit het
uit he t=uit het
bi j een=bij een
het n iet=het niet
aan he t=aan het
ov er het=over het
me t de=met de
den k ik=denk ik
van h en=van hen
naar buit en=naar buiten
M aar ook=Maar ook
kost en van=kosten van
zelf s een=zelfs een
te n aanzien=ten aanzien
en w eer=en weer
ze zij n=ze zijn
de woord en=de woorden
aan mij n=aan mijn
ik den k=ik denk
Van de r=Van der
n iet als=niet als
kom t de=komt de
kom t het=komt het
I k ga=Ik ga
wet en te=weten te
wan t de=want de
met iemand dat=met iemand die
en he tis=en het is
w aarde van=waarde van
kom t er=komt er
twee j aar=twee jaar
het verstreken van=het verstrekken van
dat mij n=dat mijn
e en of=een of
het groots te=het grootste
voor di t=voor dit
je heb t=je hebt
zij n. De=zijn. De
en mij n=en mijn
veel mens en=veel mensen
j aar in=jaar in
w as een=was een
d at het=dat het
en e en=en een
volgen s het=volgens het
me n in=men in
mi n of=min of
do or de=door de
va n een=van een
v oor de=voor de
je de ze=je deze
de betreffend e=de betreffende
v oor een=voor een
Het w as=Het was
tij d voor=tijd voor
en me t=en met
o ver de=over de
op zij n=op zijn
Sam en met=Samen met
en w orden=en worden
het b ij=het bij
de Kame r=de Kamer
de t wee=de twee
nog n iet=nog niet
heef t een=heeft een
was e en=was een
I n dat=In dat
zij n het=zijn het
j aar een=jaar een
ook al s=ook als
I k moet=Ik moet
we l heel=wel heel
zij n vrouw=zijn vrouw
zij n gezicht=zijn gezicht
is we er=is weer
word en om=worden om
alle en voor=alleen voor
alle en nog=alleen nog
voor e en=voor een
d at de=dat de
v oor alle=voor alle
m aar ik=maar ik
kan word en=kan worden
M aar het=Maar het
niet me t=niet met
om zij n=om zijn
een j aar=een jaar
er e en=er een
d oor het=door het
en da t=en dat
en d at=en dat
me t deze=met deze
om me t=om met
zo u de=zou de
B ij een=Bij een
da t hij=dat hij
door he t=door het
w aar we=waar we
op di t=op dit
een belangrijk e=een belangrijke
te n opzichte=ten opzichte
toch n iet=toch niet
is da t=is dat
I k weet=Ik weet
en va n=en van
het eerst e=het eerste
niet m eer=niet meer
n iet meer=niet meer
n aar het=naar het
dat h ij=dat hij
zou zij n=zou zijn
met mij n=met mijn
om e en=om een
echt er niet=echter niet
I k was=Ik was
bi j het=bij het
een klein e=een kleine
De nieuw e=De nieuwe
Hi j is=Hij is
da t die=dat die
er w el=er wel
He t gaat=Het gaat
zo u kunnen=zou kunnen
d it is=dit is
w aren de=waren de
w aar hij=waar hij
me t die=met die
word t er=wordt er
voor m ij=voor mij
het nieuw e=het nieuwe
het j aar=het jaar
w orden in=worden in
die zij n=die zijn
vorig j aar=vorig jaar
I k had=Ik had
door zij n=door zijn
d ie de=die de
B ij het=Bij het
zo u het=zou het
Hi j had=Hij had
heel w at=heel wat
zij n met=zijn met
I k denk=Ik denk
dat hi j=dat hij
dat w ij=dat wij
en word t=en wordt
k ader van=kader van
het k ader=het kader
er zij n=er zijn
word en door=worden door
al s een=als een
als e en=als een
word t door=wordt door
hi j de=hij de
is v oor=is voor
die he t=die het
ook n iet=ook niet
van d it=van dit
die e en=die een
in mij n=in mijn
niet lang er=niet langer
van d ie=van die
b ij het=bij het
n iet zo=niet zo
de el van=deel van
tijden s de=tijdens de
m aar de=maar de
zij n de=zijn de
Da t is=Dat is
ov er een=over een
tot e en=tot een
S amen met=Samen met
da t de=dat de
in e en=in een
van m ij=van mij
kan zij n=kan zijn
is e en=is een
word t op=wordt op
op he t=op het
va n haar=van haar
tien j aar=tien jaar
m aar ook=maar ook
va n het=van het
va n de=van de
van he t=van het
w el een=wel een
n iet alleen=niet alleen
aan e en=aan een
van di e=van die
in he t=in het
op e en=op een
I k ben=Ik ben
de han d=de hand
een ander e=een andere
Ik h eb=Ik heb
is he t=is het
n aar de=naar de
na ar de=naar de
v oor het=voor het
voor he t=voor het
zij n er=zijn er
heef t de=heeft de
me t het=met het
zij n en=zijn en
I k kan=Ik kan
moeten w orden=moeten worden
bas is van=basis van
moet en worden=moeten worden
nog een s=nog eens
zij n niet=zijn niet
naar he t=naar het
en b ij=en bij
een nieuw e=een nieuwe
over he t=over het
u it de=uit de
w as de=was de
ov er de=over de
He t is=Het is
ui t de=uit de
bi j de=bij de
er n iet=er niet
d oor de=door de
e en andere=een andere
politie operatie=politieoperatie
mode artikel=modeartikel
vakantie activiteit=vakantieactiviteit
communicatie oplossing=communicatieoplossing
vegetatie opnamen=vegetatieopnamen
knie operaties=knieoperaties
olie opbrengsten=olieopbrengsten
transactie overzichten=transactieoverzichten
studie objecten=studieobjecten
wiskunde opgaven=wiskundeopgaven
recreatie appartementen=recreatieappartementen
stilte oefening=stilteoefening
bridge avond=bridgeavond
nicotine aanslag=nicotineaanslag
cassatie advocaat=cassatieadvocaat
semi overheden=semioverheden
energie afgifte=energieafgifte
semi automatisch=semiautomatisch
applicatie ontwikkelaar=applicatieontwikkelaar
sproei armen=sproeiarmen
applicatie ontwikkelaars=applicatieontwikkelaars
domicilie adres=domicilieadres
reclame acties=reclameacties
energie overschot=energieoverschot
zee aas=zeeaas
selectie activiteiten=selectieactiviteiten
familie attractie=familieattractie
competitie avond=competitieavond
kooi aap=kooiaap
informatie analisten=informatieanalisten
gemeente overheid=gemeenteoverheid
waarde ontwikkelingen=waardeontwikkelingen
studie avonden=studieavonden
rente aanbod=renteaanbod
premie ontwikkeling=premieontwikkeling
premie opslag=premieopslag
studie ondersteuning=studieondersteuning
hooi oogst=hooioogst
game ontwerper=gameontwerper
gemeente administratie=gemeenteadministratie
exploitatie overschot=exploitatieoverschot
energie aansluiting=energieaansluiting
evaluatie activiteiten=evaluatieactiviteiten
thema ochtend=themaochtend
video advertenties=videoadvertenties
studie ochtend=studieochtend
milieu afdeling=milieuafdeling
actie aanbieding=actieaanbieding
draai arm=draaiarm
geboorte afwijking=geboorteafwijking
reparatie advies=reparatieadvies
frame ontwerp=frameontwerp
registratie autoriteit=registratieautoriteit
video aanbod=videoaanbod
media organisatie=mediaorganisatie
toernooi overwinning=toernooioverwinning
overname activiteiten=overnameactiviteiten
koffie oogst=koffieoogst
ruimte organisatie=ruimteorganisatie
zee aquaria=zeeaquaria
referentie objecten=referentieobjecten
franje apen=franjeapen
facturatie adres=facturatieadres
entree opleiding=entreeopleiding
homo acceptatie=homoacceptatie
hoogte accent=hoogteaccent
demo account=demoaccount
reserve officieren=reserveofficieren
stage activiteiten=stageactiviteiten
assemblage afdeling=assemblageafdeling
mode afdeling=modeafdeling
foto afdeling=fotoafdeling
transactie overzicht=transactieoverzicht
pseudo acacia=pseudoacacia
octrooi aanvrage=octrooiaanvrage
volume ontwikkeling=volumeontwikkeling
dooi aanval=dooiaanval
mode advies=modeadvies
website ontwerp=websiteontwerp
coördinatie oefeningen=coördinatieoefeningen
informatie opslag=informatieopslag
actie aanbod=actieaanbod
preventie advies=preventieadvies
munitie opslag=munitieopslag
energie aanvoer=energieaanvoer
animatie activiteiten=animatieactiviteiten
porno actrices=pornoactrices
douche olie=doucheolie
première avond=premièreavond
warmte opname=warmteopname
groei echo=groeiecho
gemeente arbeiders=gemeentearbeiders
prestige object=prestigeobject
televisie ontvangst=televisieontvangst
energie adviseurs=energieadviseurs
campagne activiteiten=campagneactiviteiten
paraffine olie=paraffineolie
groei aandeel=groeiaandeel
communicatie acties=communicatieacties
studie omgeving=studieomgeving
lente akkoord=lenteakkoord
draai orgeltjes=draaiorgeltjes
semi overheid=semioverheid
taxatie opdracht=taxatieopdracht
theorie avond=theorieavond
rechter voet=rechtervoet
linker been=linkerbeen
milieu argumenten=milieuargumenten
linker oor=linkeroor
linker voet=linkervoet
linker wang=linkerwang
rechter arm=rechterarm
rechter been=rechterbeen
rechter oor=rechteroor
rechter wang=rechterwang
stage aanbieders=stageaanbieders
linker mouw=linkermouw
linker pijp=linkerpijp
linker schoen=linkerschoen
diepte analyse=diepteanalyse
media opvoeding=mediaopvoeding
familie aangelegenheid=familieaangelegenheid
reclame objecten=reclameobjecten
programma organisatie=programmaorganisatie
controle organen=controleorganen
repressie apparaat=repressieapparaat
premie achterstand=premieachterstand
fractie assistenten=fractieassistenten
radio astronomie=radioastronomie
garantie afhandeling=garantieafhandeling
communicatie opleiding=communicatieopleiding
luxe appartement=luxeappartement
reclame opbrengsten=reclameopbrengsten
controle afspraken=controleafspraken
camera oog=cameraoog
horeca opleiding=horecaopleiding
studie aanpak=studieaanpak
meditatie oefening=meditatieoefening
studio apparatuur=studioapparatuur
drie assige=drieassige
milieu administratie=milieuadministratie
observatie afdeling=observatieafdeling
productie aantal=productieaantal
ruimte avontuur=ruimteavontuur
groei afwijkingen=groeiafwijkingen
vanille aroma=vanillearoma
bureau accessoires=bureauaccessoires
energie opties=energieopties
reclame afdeling=reclameafdeling
garantie aanspraken=garantieaanspraken
mede aansprakelijk=medeaansprakelijk
milieu acties=milieuacties
innovatie adviseur=innovatieadviseur
ziekte oorzaken=ziekteoorzaken
compilatie album=compilatiealbum
klei oven=kleioven
douane aangifte=douaneaangifte
coalitie akkoorden=coalitieakkoorden
massage apparaat=massageapparaat
klei afzettingen=kleiafzettingen
specialisatie opleidingen=specialisatieopleidingen
advertentie opbrengsten=advertentieopbrengsten
pagina opmaak=paginaopmaak
route aanwijzingen=routeaanwijzingen
type aanduidingen=typeaanduidingen
oranje achtige=oranjeachtige
industrie arbeiders=industriearbeiders
waarde overdrachten=waardeoverdrachten
vrede offers=vredeoffers
surveillance auto's=surveillanceauto's
reserve accu=reserveaccu
meditatie oefeningen=meditatieoefeningen
fusie operaties=fusieoperaties
chef staf=chefstaf
video analyse=videoanalyse
zonne allergie=zonneallergie
energie oplossingen=energieoplossingen
remise aanbod=remiseaanbod
studie aanbod=studieaanbod
promotie activiteit=promotieactiviteit
reclame affiches=reclameaffiches
opname omstandigheden=opnameomstandigheden
data oplossingen=dataoplossingen
commando actie=commandoactie
carrière advies=carrièreadvies
casino avond=casinoavond
castratie angst=castratieangst
communicatie oplossingen=communicatieoplossingen
defensie opdrachten=defensieopdrachten
mutatie overzicht=mutatieoverzicht
rogge akkers=roggeakkers
organisatie aspecten=organisatieaspecten
mode atelier=modeatelier
communicatie opleidingen=communicatieopleidingen
restauratie architect=restauratiearchitect
service activiteiten=serviceactiviteiten
prestatie afhankelijke=prestatieafhankelijke
sproei arm=sproeiarm
vakantie adresjes=vakantieadresjes
milieu analyse=milieuanalyse
roze achtig=rozeachtig
re absorptie=reabsorptie
competitie overwinning=competitieoverwinning
auto advertentie=autoadvertentie
barbecue avond=barbecueavond
accreditatie orgaan=accreditatieorgaan
commando acties=commandoacties
controle ambtenaar=controleambtenaar
controle ambtenaren=controleambtenaren
demonstratie avond=demonstratieavond
dioxine affaire=dioxineaffaire
energie opname=energieopname
zee orgel=zeeorgel
heide achtige=heideachtige
gemeente opbouw=gemeenteopbouw
visualisatie oefeningen=visualisatieoefeningen
reorganisatie ontslag=reorganisatieontslag
risico afdekking=risicoafdekking
gemeente ontvanger=gemeenteontvanger
groente afdeling=groenteafdeling
televisie optreden=televisieoptreden
radio antennes=radioantennes
mede overheden=medeoverheden
carrière opbouw=carrièreopbouw
energie ambities=energieambities
rente opslagen=renteopslagen
spaghetti avond=spaghettiavond
productie activiteit=productieactiviteit
vakantie opbouw=vakantieopbouw
route omschrijving=routeomschrijving
medicatie overdracht=medicatieoverdracht
geleide ogen=geleideogen
diagnose apparaat=diagnoseapparaat
armoede organisaties=armoedeorganisaties
service apparaat=serviceapparaat
draai uur=draaiuur
televisie abonnement=televisieabonnement
service afspraken=serviceafspraken
introductie aanbod=introductieaanbod
innovatie activiteiten=innovatieactiviteiten
cassatie arrest=cassatiearrest
communicatie ambtenaar=communicatieambtenaar
mini opera=miniopera
agressie oorlog=agressieoorlog
studie adviseurs=studieadviseurs
service auto's=serviceauto's
televisie aanbod=televisieaanbod
stage adres=stageadres
auto ambulance=autoambulance
politie opleiding=politieopleiding
installatie ontwerp=installatieontwerp
milieu activisme=milieuactivisme
milieu activiste=milieuactiviste
live opnames=liveopnames
warmte overschot=warmteoverschot
douane afhandeling=douaneafhandeling
keuze oefeningen=keuzeoefeningen
karaoke avond=karaokeavond
peri operatieve=perioperatieve
conditie oefeningen=conditieoefeningen
acceptatie omgeving=acceptatieomgeving
concurrentie analyses=concurrentieanalyses
massage oli[ën=massageoli[ën
regressie analyses=regressieanalyses
risico acceptatie=risicoacceptatie
informatie overvloed=informatieovervloed
incasso activiteiten=incassoactiviteiten
koffie aroma=koffiearoma
navigatie aanwijzingen=navigatieaanwijzingen
milieu economie=milieueconomie
milieu onvriendelijker=milieuonvriendelijker
mini album=minialbum
mode opleidingen=modeopleidingen
machine olie=machineolie
defensie organisaties=defensieorganisaties
medaille oogst=medailleoogst
lease offerte=leaseofferte
foto apparaten=fotoapparaten
crème achtige=crèmeachtige
regio adviseur=regioadviseur
preventie adviezen=preventieadviezen
politie arts=politiearts
luxe appartementen=luxeappartementen
milieu agenda=milieuagenda
mode ontwerp=modeontwerp
douane aangiften=douaneaangiften
conditie opbouw=conditieopbouw
productie assistent=productieassistent
branche ontwikkelingen=brancheontwikkelingen
assurantie adviseurs=assurantieadviseurs
stage aanvraag=stageaanvraag
familie avond=familieavond
energie audits=energieaudits
fraude officier=fraudeofficier
waarde aanduiding=waardeaanduiding
vakantie attest=vakantieattest
controle organisme=controleorganisme
hoogte accenten=hoogteaccenten
thee assortiment=theeassortiment
bagage afdeling=bagageafdeling
installatie automaat=installatieautomaat
populatie opbouw=populatieopbouw
energie aandelen=energieaandelen
organisatie omgeving=organisatieomgeving
defensie orders=defensieorders
overname adviseur=overnameadviseur
productie atelier=productieatelier
preventie assistenten=preventieassistenten
meditatie avond=meditatieavond
rogge oogst=roggeoogst
milieu afspraken=milieuafspraken
sirene alarm=sirenealarm
associatie akkoord=associatieakkoord
adoptie akte=adoptieakte
crème achtig=crèmeachtig
energie aanbieders=energieaanbieders
antenne aansluiting=antenneaansluiting
alimentatie afspraken=alimentatieafspraken
televisie opname=televisieopname
studie adviezen=studieadviezen
familie avondje=familieavondje
bèta onderwijs=bètaonderwijs
registratie aanvraag=registratieaanvraag
redactie overleg=redactieoverleg
politie agentes=politieagentes
radio antenne=radioantenne
parochie archief=parochiearchief
politie afdelingen=politieafdelingen
olie ontginning=olieontginning
live album=livealbum
fractie ondersteuning=fractieondersteuning
risico arme=risicoarme
tosti apparaat=tostiapparaat
dance acts=danceacts
distributie apparaat=distributieapparaat
communicatie apparaat=communicatieapparaat
expeditie afdeling=expeditieafdeling
roei apparaten=roeiapparaten
operatie assistente=operatieassistente
reflectie opdrachten=reflectieopdrachten
linker arm=linkerarm
indeplaats stelling=indeplaatsstelling
risico aanvaarding=risicoaanvaarding
kandidaat stelling=kandidaatstelling
op klapbaar=opklapbaar
linker flank=linkerflank
linker verdediger=linkerverdediger
linker deur=linkerdeur
bij voorbeeld=bijvoorbeeld
linker vleugel=linkervleugel
rechter spits=rechterspits
mode ontwerper=modeontwerper
heilig making=heiligmaking
al weer=alweer	Misschien bedoelt u alweer (opnieuw)?
gemeente archief=gemeentearchief
levend making=levendmaking
prestatie afspraken=prestatieafspraken
onder curatelestelling=ondercuratelestelling
ondercuratele stelling=ondercuratelestelling
linker portier=linkerportier
linker zijde=linkerzijde
on line=online
feed back=feedback
onder erfstelling=ondererfstelling
tekoop stelling=tekoopstelling
discussie avond=discussieavond
milieu aspecten=milieuaspecten
organisatie adviseur=organisatieadviseur
cadeau artikelen=cadeauartikelen
onder neming=onderneming
milieu effecten=milieueffecten
rechter schoen=rechterschoen
telaste legging=telastelegging
tante zeggers=tantezeggers
gezond making=gezondmaking
tante zeggertje=tantezeggertje
tante zeggertjes=tantezeggertjes
oom zegger=oomzegger
oom zeggers=oomzeggers
lease auto's=leaseauto's
politie auto's=politieauto's
sla olie=slaolie
buiten gevolgstelling=buitengevolgstelling
harmonie orkest=harmonieorkest
deel neming=deelneming
data opslag=dataopslag
linker spatbord=linkerspatbord
in tact=intact
buiten gebruikstelling=buitengebruikstelling
buiten bezitstelling=buitenbezitstelling
buitengevecht stelling=buitengevechtstelling
rechter flank=rechterflank
rechter vleugel=rechtervleugel
in klapbaar=inklapbaar
neer klapbaar=neerklapbaar
rechter bovenhoek=rechterbovenhoek
in pandgeving=inpandgeving
inpand geving=inpandgeving
instand houding=instandhouding
in standhouding=instandhouding
in verzekeringstelling=inverzekeringstelling
inverzekering stelling=inverzekeringstelling
inverzuim stelling=inverzuimstelling
in verzuimstelling=inverzuimstelling
rechter zijde=rechterzijde
rechter trapper=rechtertrapper
ondererf stelling=ondererfstelling
buitengevolg stelling=buitengevolgstelling
rechter zijbeuk=rechterzijbeuk
tante zegger=tantezegger
tegelijker tijd=tegelijkertijd
laag drempelig=laagdrempelig
aanhangig making=aanhangigmaking
bewust making=bewustmaking
buitenbezit stelling=buitenbezitstelling
buitengebruik stelling=buitengebruikstelling
gevoelloos making=gevoelloosmaking
rechter spatbord=rechterspatbord
een zelfde=eenzelfde
inbedrijf stelling=inbedrijfstelling
productie omgeving=productieomgeving
te lastelegging=telastelegging
linker bovenhoek=linkerbovenhoek
rechter deur=rechterdeur
rechter koplamp=rechterkoplamp
rechter portier=rechterportier
ventilatie openingen=ventilatieopeningen
informatie overdracht=informatieoverdracht
biologie onderwijs=biologieonderwijs
snoei afval=snoeiafval
ter postbezorging=terpostbezorging
terbeschikking stelling=terbeschikkingstelling
terdood brenging=terdoodbrenging
zo iets=zoiets
terhand neming=terhandneming
scheeps recht=scheepsrecht
terhand stelling=terhandstelling
branche organisaties=brancheorganisaties
ter leengeving=terleengeving
terinzage legging=terinzagelegging
ten uitvoerlegging=tenuitvoerlegging
terleen geving=terleengeving
ter aardebestelling=teraardebestelling
terpost bezorging=terpostbezorging
ter zijdelating=terzijdelating
terzijde lating=terzijdelating
ter doodveroordeling=terdoodveroordeling
naai atelier=naaiatelier
race auto=raceauto
scheeps kas=scheepskas
scheeps officieren=scheepsofficieren
subsidie aanvraag=subsidieaanvraag
scheeps register=scheepsregister
energie opwekking=energieopwekking
warming up=warming-up
goji bes=gojibes
salsa lessen=salsalessen
linker spits=linkerspits
draai orgel=draaiorgel
scheeps ruimte=scheepsruimte
ter inzagelegging=terinzagelegging
ter doodbrenging=terdoodbrenging
ter zijdestelling=terzijdestelling
branche organisatie=brancheorganisatie
terdood veroordeling=terdoodveroordeling
risico analyses=risicoanalyses
ter handneming=terhandneming
software ontwikkeling=softwareontwikkeling
ter handstelling=terhandstelling
hypo allergeen=hypoallergeen
attractie aanbod=attractieaanbod
geboorte akte=geboorteakte
familie omstandigheden=familieomstandigheden
rente aftrek=renteaftrek
groei omstandigheden=groeiomstandigheden
koffie apparaat=koffieapparaat
revalidatie arts=revalidatiearts
oom zeggertje=oomzeggertje
draai uren=draaiuren
milieu organisatie=milieuorganisatie
kris kras=kriskras
non valeur=nonvaleur
vakantie oord=vakantieoord
politie ambtenaren=politieambtenaren
koffie automaat=koffieautomaat
symfonie orkest=symfonieorkest
gemeente ambtenaren=gemeenteambtenaren
vee arts=veearts
radio activiteit=radioactiviteit
milieu eisen=milieueisen
offerte aanvraag=offerteaanvraag
ingebruik treding=ingebruiktreding
van zelfsprekend=vanzelfsprekend
oom zeggertjes=oomzeggertjes
lease auto=leaseauto
limoen amandelcake=limoenamandelcake
gemeente ambtenaar=gemeenteambtenaar
mode ontwerpers=modeontwerpers
foto album=fotoalbum
communicatie adviseur=communicatieadviseur
milieu organisaties=milieuorganisaties
organisatie ontwikkeling=organisatieontwikkeling
vakantie adres=vakantieadres
politie auto=politieauto
energie opslag=energieopslag
informatie avonden=informatieavonden
coalitie akkoord=coalitieakkoord
formatie opdracht=formatieopdracht
ouder kindrelatie=ouderkindrelatie
adoptie ouders=adoptieouders
waarde ontwikkeling=waardeontwikkeling
info avond=infoavond
functie omschrijving=functieomschrijving
buiten gevechtstelling=buitengevechtstelling
urine onderzoek=urineonderzoek
kraai achtige=kraaiachtige
applicatie architectuur=applicatiearchitectuur
regularisatie aanvraag=regularisatieaanvraag
provincie ambtenaar=provincieambtenaar
race overall=raceoverall
auto alarmen=autoalarmen
waarde opbouw=waardeopbouw
televisie aansluiting=televisieaansluiting
studie opzet=studieopzet
familie omgeving=familieomgeving
bio afval=bioafval
coördinatie orgaan=coördinatieorgaan
dialyse apparaat=dialyseapparaat
collecte opbrengst=collecteopbrengst
informatie architecten=informatiearchitecten
instructie avond=instructieavond
milieu adviseur=milieuadviseur
functie aanbod=functieaanbod
functie aanduidingen=functieaanduidingen
risico adviseur=risicoadviseur
service auto=serviceauto
solo artiesten=soloartiesten
tropische plantenkwekerij=tropischeplantenkwekerij
goji bessen=gojibessen
rechtermuis knop=rechtermuisknop
walkie talkie=walkietalkie
vader-zoon relatie=vader-zoonrelatie
kop-staart aanrijding=kop-staartaanrijding
vader-zoon band=vader-zoonband
schade aangifte=schadeaangifte
platte kaas=plattekaas
down under=downunder
decennia oude=decenniaoude
kop-staart botsing=kop-staartbotsing
auto aanpassing=autoaanpassing
koudwater vissen=koudwatervissen	Hoort deze spatie er echt?
niet tegenstaande=niettegenstaande
kungfu school=kungfuschool
software omgeving=softwareomgeving
coalitie overleg=coalitieoverleg
confectie atelier=confectieatelier
website ontwikkeling=websiteontwikkeling
porno acteurs=pornoacteurs
rechter muisknop=rechtermuisknop
emancipatie ambtenaar=emancipatieambtenaar
post-hbo opleiding=post-hbo-opleiding
koffie apparatuur=koffieapparatuur
warmte afgifte=warmteafgifte
productie afdeling=productieafdeling
politie aanwezigheid=politieaanwezigheid
ventilatie oplossing=ventilatieoplossing
foto atelier=fotoatelier
franje aap=franjeaap
energie aanbieder=energieaanbieder
scoot mobiel=scootmobiel
etappe overwinning=etappeoverwinning
nota overleg=notaoverleg
locatie afhankelijke=locatieafhankelijke
tarwe allergie=tarweallergie
stage adressen=stageadressen
vice admiraal=viceadmiraal
justitie assistent=justitieassistent
volume afspraken=volumeafspraken
foto artikelen=fotoartikelen
productie opdrachten=productieopdrachten
telefonie oplossing=telefonieoplossing
familie organisaties=familieorganisaties
surveillance auto=surveillanceauto
website adressen=websiteadressen
zee organismen=zeeorganismen
machine onderhoud=machineonderhoud
evacuatie oefening=evacuatieoefening
giro afschrift=giroafschrift
foto actie=fotoactie
exploitatie overzicht=exploitatieoverzicht
vakantie auto=vakantieauto
ei afzetting=eiafzetting
waarde aangroei=waardeaangroei
situatie afhankelijk=situatieafhankelijk
situatie analyse=situatieanalyse
zee oorlog=zeeoorlog
politie organisaties=politieorganisaties
zee officier=zeeofficier
software architectuur=softwarearchitectuur
dioxine achtige=dioxineachtige
prikkelbare darmsyndroom=prikkelbaredarmsyndroom
prikkelbaar darmsyndroom=prikkelbaredarmsyndroom
warmte ontwikkeling=warmteontwikkeling
linker trapper=linkertrapper
in bewaringgeving=inbewaringgeving
in bewaringneming=inbewaringneming
inbewaring neming=inbewaringneming
inbewaring stelling=inbewaringstelling
in bewaringstelling=inbewaringstelling
inbezit neming=inbezitneming
in gebruiktreding=ingebruiktreding
in dienstneming=indienstneming
inbeslag neming=inbeslagneming
indienst stelling=indienststelling
in dienststelling=indienststelling
indienst treding=indiensttreding
in diensttreding=indiensttreding
in gebrekestelling=ingebrekestelling
ingebreke stelling=ingebrekestelling
ingebruik neming=ingebruikneming
in gebruikneming=ingebruikneming
inbewaring geving=inbewaringgeving
in beslagneming=inbeslagneming
inde plaatsstelling=indeplaatsstelling
strafbaar stelling=strafbaarstelling
zee arend=zeearend
onder toezichtstelling=ondertoezichtstelling
ondertoezicht stelling=ondertoezichtstelling
onvruchtbaar making=onvruchtbaarmaking
openbaar making=openbaarmaking
opjaren stelling=opjarenstelling
op jarenstelling=opjarenstelling
ruchtbaar making=ruchtbaarmaking
te boekstelling=teboekstelling
inbeschuldiging stelling=inbeschuldigingstelling
teboek stelling=teboekstelling
tegelde making=tegeldemaking
te geldemaking=tegeldemaking
te koopstelling=tekoopstelling
onder handstelling=onderhandstelling
in bedrijfstelling=inbedrijfstelling
in ontvangstneming=inontvangstneming
inhechtenis neming=inhechtenisneming
in bezitneming=inbezitneming
in deplaatsstelling=indeplaatsstelling
gado gado=gadogado
prestatie afspraak=prestatieafspraak
groei agenda=groeiagenda
conferentie oorden=conferentieoorden
lekke darmsyndroom=lekkedarmsyndroom
route aanduiding=routeaanduiding
diepte aanslag=diepteaanslag
cadeau artikel=cadeauartikel
recreatie aanbod=recreatieaanbod
bridge avonden=bridgeavonden
video analyses=videoanalyses
milieu ambities=milieuambities
piri piri=piripiri
fifty fifty=fiftyfifty
lump sum=lumpsum
wellis waar=weliswaar
cliff hanger=cliffhanger
ter beschikkingstelling=terbeschikkingstelling
vader-zoon verhouding=vader-zoonverhouding
tropische plantenkweker=tropischeplantenkweker
media oorlog=mediaoorlog
massa opslag=massaopslag
indienst neming=indienstneming
in bezittreding=inbezittreding
in hechtenisneming=inhechtenisneming
inbezit treding=inbezittreding
linker zijbeuk=linkerzijbeuk
in beschuldigingstelling=inbeschuldigingstelling
linker koplamp=linkerkoplamp
rechter verdediger=rechterverdediger
inontvangst neming=inontvangstneming
onderhand stelling=onderhandstelling
pietje precies=pietjeprecies
auto aanpassingen=autoaanpassingen
kung fu=kungfu
in gebruikname=ingebruikname
be drag=bedrag
popie jopie=popiejopie
warmwater comfort=warmwatercomfort
informatie ontsluiting=informatieontsluiting
subsidie adviseurs=subsidieadviseurs
software aanbod=softwareaanbod
licentie aanvraag=licentieaanvraag
tele objectief=teleobjectief
functie afdeling=functieafdeling
zaai uien=zaaiuien
micro algen=microalgen
software applicatie=softwareapplicatie
bende oorlog=bendeoorlog
retro actieve=retroactieve
vacature overzicht=vacatureoverzicht
zee algen=zeealgen
ziekte activiteit=ziekteactiviteit
concurrentie oogpunt=concurrentieoogpunt
valuta oorlog=valutaoorlog
ruimte afval=ruimteafval
technologie ontwikkeling=technologieontwikkeling
productie organisatie=productieorganisatie
media organisaties=mediaorganisaties
schade oorzaken=schadeoorzaken
schalie olie=schalieolie
mega operatie=megaoperatie
groente afval=groenteafval
koffie apparaten=koffieapparaten
programma ontwikkeling=programmaontwikkeling
fusie organisatie=fusieorganisatie
psycho analytici=psychoanalytici
excursie aanbod=excursieaanbod
informatie architect=informatiearchitect
productie aantallen=productieaantallen
decoratie artikelen=decoratieartikelen
vakantie appartementen=vakantieappartementen
migraine aanvallen=migraineaanvallen
service abonnement=serviceabonnement
radio apparatuur=radioapparatuur
promotie artikel=promotieartikel
repetitie avonden=repetitieavonden
auto alarm=autoalarm
marine officier=marineofficier
actie agenda=actieagenda
milieu activisten=milieuactivisten
mode ontwerpen=modeontwerpen
co axiaal=coaxiaal
co auteurs=coauteurs
mode artikelen=modeartikelen
operatie afdeling=operatieafdeling
zee olifanten=zeeolifanten
competitie opzet=competitieopzet
vakantie accommodaties=vakantieaccommodaties
ultra orthodoxe=ultraorthodoxe
energie aanbod=energieaanbod
fase overgang=faseovergang
mede oorzaak=medeoorzaak
energie arm=energiearm
hernia operatie=herniaoperatie
solo actie=soloactie
regie assistent=regieassistent
informatie aanvragen=informatieaanvragen
operatie assistent=operatieassistent
reclame activiteiten=reclameactiviteiten
rente opbrengst=renteopbrengst
navigatie apparaat=navigatieapparaat
zonne auto=zonneauto
radio amateur=radioamateur
preventie activiteiten=preventieactiviteiten
tarwe oogst=tarweoogst
keuze aanbod=keuzeaanbod
pre adviezen=preadviezen
media optredens=mediaoptredens
reclame actie=reclameactie
warmte opwekking=warmteopwekking
fanfare orkesten=fanfareorkesten
communicatie afdelingen=communicatieafdelingen
draai orgeltje=draaiorgeltje
bingo avonden=bingoavonden
combi oven=combioven
controle apparaat=controleapparaat
centi are=centiare
po[ëzie album=po[ëziealbum
politie officier=politieofficier
draai as=draaias
risico afweging=risicoafweging
bende oorlogen=bendeoorlogen
oranje achtig=oranjeachtig
communicatie aanpak=communicatieaanpak
opinie artikelen=opinieartikelen
opname apparaat=opnameapparaat
rente opbrengsten=renteopbrengsten
groei ambitie=groeiambitie
vakantie oorden=vakantieoorden
game ontwikkelaars=gameontwikkelaars
productie afval=productieafval
espresso apparaten=espressoapparaten
familie archieven=familiearchieven
mutatie onderhoud=mutatieonderhoud
milieu advies=milieuadvies
lente ochtend=lenteochtend
regie opleiding=regieopleiding
recreatie activiteiten=recreatieactiviteiten
informatie ochtend=informatieochtend
porno acteur=pornoacteur
keuze optie=keuzeoptie
installatie adviseur=installatieadviseur
compositie opdracht=compositieopdracht
douane ambtenaren=douaneambtenaren
politie officieren=politieofficieren
mede organisatoren=medeorganisatoren
opname afdeling=opnameafdeling
reclame object=reclameobject
mede auteurs=medeauteurs
route opdrachten=routeopdrachten
promotie acties=promotieacties
risico aversie=risicoaversie
promotie artikelen=promotieartikelen
zee otter=zeeotter
menu opties=menuopties
televisie opnames=televisieopnames
premie aftrek=premieaftrek
milieu argument=milieuargument
milieu overtredingen=milieuovertredingen
locatie ontwikkeling=locatieontwikkeling
olie afscheider=olieafscheider
politie aanpak=politieaanpak
familie aangelegenheden=familieaangelegenheden
twee assige=tweeassige
televisie opnamen=televisieopnamen
ruimte aanbod=ruimteaanbod
controle activiteiten=controleactiviteiten
relatie opbouw=relatieopbouw
premie afdracht=premieafdracht
organisatie ontwerp=organisatieontwerp
principe akkoord=principeakkoord
milieu activist=milieuactivist
politie optreden=politieoptreden
woede aanval=woedeaanval
fraude aanpak=fraudeaanpak
relaxatie oefeningen=relaxatieoefeningen
calorie opname=calorieopname
distributie activiteiten=distributieactiviteiten
organisatie ontwikkelingen=organisatieontwikkelingen
concentratie oefeningen=concentratieoefeningen
schade oorzaak=schadeoorzaak
milieu omstandigheden=milieuomstandigheden
energie afhankelijkheid=energieafhankelijkheid
franchise organisaties=franchiseorganisaties
familie archief=familiearchief
studie opdracht=studieopdracht
emissie arme=emissiearme
pre operatieve=preoperatieve
correspondentie adres=correspondentieadres
conferentie oord=conferentieoord
calorie arm=caloriearm
benzine auto's=benzineauto's
defensie organisatie=defensieorganisatie
vegetatie ontwikkeling=vegetatieontwikkeling
opname apparatuur=opnameapparatuur
directie overleg=directieoverleg
familie auto=familieauto
benzine accijns=benzineaccijns
finale avond=finaleavond
fanfare orkest=fanfareorkest
benzine auto=benzineauto
co auteur=coauteur
theorie avonden=theorieavonden
milieu activiteiten=milieuactiviteiten
echo apparatuur=echoapparatuur
audio apparaat=audioapparaat
subsidie advies=subsidieadvies
technologie overdracht=technologieoverdracht
foto archieven=fotoarchieven
audio apparaten=audioapparaten
mode opleiding=modeopleiding
strategie ontwikkeling=strategieontwikkeling
subsidie aanvragers=subsidieaanvragers
vakantie accommodatie=vakantieaccommodatie
controle aanpak=controleaanpak
controle opdracht=controleopdracht
mede oprichters=medeoprichters
intercom systeem=intercomsysteem	Vast een spatiefout
qwerty keyboard=qwertykeyboard
aan zienlijk=aanzienlijk	Spatiefout
aan zienlijke=aanzienlijke	Spatiefout
aan zienlijker=aanzienlijker	Spatiefout
aan zienlijkst=aanzienlijkst	Spatiefout
aan zienlijkste=aanzienlijkste	Spatiefout
buitenbewust zijn=buiten bewustzijn	Vast een spatiefout
ICT geletterd=ICT-geletterd	Vast een spatiefout
qwerty toetsenbord=qwertytoetsenbord
ICT onderwijs=ICT-onderwijs	Vast een spatiefout
covid 19=COVID-19
corona virus=coranavirus
anderhalve meterregel=anderhalvemeterregel
soep smaak=soepsmaak|soep smaakt
verveeld zich=verveelt zich
baby schapen=babyschapen
uurwerk werk=uurwerk werkt
azerty keyboard=azertykeyboard
azerty toetsenbord=azertytoetsenbord
Realo schatting=Realoschatting|Realo-schatting
signaal ruisverhoudingen=signaal-ruisverhoudingen
horror scenario=horrorscenario
dode hoeklessen=dodehoeklessen
dode hoekles=dodehoekles
liefde-haat verhouding=liefde-haatverhouding
school jaar=schooljaar
youtube video's=YouTubevideo's
liefde-haat relatie=liefde-haatrelatie
vliegens vlugge=vliegensvlugge
HBO opleiding=hbo-opleiding
te vrede=tevreden|de vrede
zin an=zin in
doormiddel van=door middel van
ezeltje strekje=ezeltje-strek-je
verborgen cameraprogramma=verborgencameraprogramma
welke geleden=die gelden|die geleden
verborgen camera-actie=verborgencamera-actie
burn out=burn-out
de wint=de wind|de winst
stijl haar=steil haar
Samsung logo=Samsunglogo
midden evaluatie=middenevaluatie
aan/uit schakelaar=aan-uitschakelaar	gelijkwaardige begrippen koppelt u met een koppelteken.
toten met=tot en met
en/ of=en/of
mmol/ l=mmol/l	bij de breukstreep in eenheden geen spatie zetten.
prijs/kwaliteit verhouding=prijs-kwaliteitverhouding	gelijkwaardige begrippen koppelt u met een koppelteken.
mg/ kg=mg/kg	bij de breukstreep in eenheden geen spatie zetten.
kopieën/ ml=kopieën/ml	bij de breukstreep in eenheden geen spatie zetten.
en/of rekening=en-ofrekening	gelijkwaardige begrippen koppelt u met een koppelteken.
verkoop/verhuur schatting=verkoop- en verhuurschatting	gelijkwaardige begrippen koppelt u met een koppelteken.
iets genist=iets gemist
lucht/water warmtepomp=lucht-waterwarmtepomp	gelijkwaardige begrippen koppelt u met een koppelteken.
kosten/baten analyse=kosten-batenanalyse	gelijkwaardige begrippen koppelt u met een koppelteken.
mach tig=machtig
mach tige=machtige
leef tijd=leeftijd
leef den=leefden
reclame sportjes=reclamespotjes
reclame sportje=reclamespotje
bren gen=brengen
voord e=voor de
4 daagse=vierdaagse
zombie ballerina=zombieballerina
ADSL internetverbinding=ADSL-internetverbinding
boven gemiddeld=bovengemiddeld
horloge loop=horloge loopt
verleend geen=verleent geen
I had=Ik had
I word=Ik word
I wou=Ik wou
gekke koeienziekte=gekkekoeienziekte
onderneming activa=ondernemingsactiva
op pijl=op peil
hardcourt ondergrond=hardcourtondergrond
Chat Log=chatlog
Nissan concessiehouders=Nissanconcessiehouders
Ik besloten=ik heb besloten|ik besloot
moslim kwestie=moslimkwestie
Ik wordt=Ik word
Zij ouders=zijn ouders
Heeft heeft=Hij heeft
nieuws item=nieuwsitem
woon werkverkeer=woon-werkverkeer
bloei aren=bloeiaren
luxe artikel=luxeartikel
informatie analist=informatieanalist
controle apparatuur=controleapparatuur
actie artikelen=actieartikelen
assurantie adviseur=assurantieadviseur
subsidie aanvrager=subsidieaanvrager
regie organisatie=regieorganisatie
consumptie artikel=consumptieartikel
game ontwikkelaar=gameontwikkelaar
justitie apparaat=justitieapparaat
functie analyse=functieanalyse
regressie analyse=regressieanalyse
dialyse afdeling=dialyseafdeling
toernooi organisatie=toernooiorganisatie
roei apparaat=roeiapparaat
mega order=megaorder
epilepsie aanvallen=epilepsieaanvallen
reparatie afdeling=reparatieafdeling
inspiratie avond=inspiratieavond
semi automatische=semiautomatische
presentatie avond=presentatieavond
auto accessoires=autoaccessoires
reclame artikelen=reclameartikelen
auto accu=autoaccu
extra ordinair=extraordinair
energie arme=energiearme
tri atlete=triatlete
milli ampère=milliampère
marine officieren=marineofficieren
analyse apparatuur=analyseapparatuur
zee otters=zeeotters
schade afdeling=schadeafdeling
solo albums=soloalbums
propaganda oorlog=propagandaoorlog
carrière ontwikkeling=carrièreontwikkeling
studie avond=studieavond
studie activiteiten=studieactiviteiten
scenario analyse=scenarioanalyse
service aanbod=serviceaanbod
familie albums=familiealbums
rente ontwikkeling=renteontwikkeling
service organisaties=serviceorganisaties
woon- werkverkeer=woon-werkverkeer
massa ontslagen=massaontslagen
productie apparatuur=productieapparatuur
douane autoriteiten=douaneautoriteiten
dame offer=dameoffer
conversie optimalisatie=conversieoptimalisatie
disco avonden=discoavonden
spionage activiteiten=spionageactiviteiten
schade auto's=schadeauto's
fusie operatie=fusieoperatie
media offensief=mediaoffensief
energie armoede=energiearmoede
energie audit=energieaudit
po[ëzie avond=po[ëzieavond
geboorte aktes=geboorteaktes
vliegens vlug=vliegensvlug
wer den=werden
goedkope arbeidsland=goedkopearbeidsland
goedkope arbeidslanden=goedkopearbeidslanden
signaal- ruisverhoudingen=signaal-ruisverhoudingen
revalidatie afdeling=revalidatieafdeling
zee aster=zeeaster
subsidie ontvangers=subsidieontvangers
fractie overleg=fractieoverleg
premie aanvraag=premieaanvraag
urgentie arts=urgentiearts
luxe artikelen=luxeartikelen
milieu ambtenaar=milieuambtenaar
douane ambtenaar=douaneambtenaar
productie auto=productieauto
rente ontwikkelingen=renteontwikkelingen
transmissie olie=transmissieolie
sabotage acties=sabotageacties
introductie avond=introductieavond
televisie avond=televisieavond
subsidie adviseur=subsidieadviseur
reserve officier=reserveofficier
successie oorlog=successieoorlog
champagne ontbijt=champagneontbijt
sterkte ontwikkeling=sterkteontwikkeling
lente avond=lenteavond
registratie apparatuur=registratieapparatuur
draai orgels=draaiorgels
warmte opslag=warmteopslag
guerrilla oorlog=guerrillaoorlog
productie auto's=productieauto's
schade auto=schadeauto
blokkade acties=blokkadeacties
indexatie ambitie=indexatieambitie
stereo apparatuur=stereoapparatuur
specialisatie opleiding=specialisatieopleiding
executie opbrengst=executieopbrengst
strooi actie=strooiactie
insuline afgifte=insulineafgifte
petitie actie=petitieactie
zee egel=zee-egel
zee anemonen=zeeanemonen
productie organisaties=productieorganisaties
politie advies=politieadvies
preventie aanpak=preventieaanpak
porno actrice=pornoactrice
productie afspraken=productieafspraken
lymfe afvoer=lymfeafvoer
telefonie omgeving=telefonieomgeving
successie aangifte=successieaangifte
applicatie ontwikkeling=applicatieontwikkeling
energie adviseur=energieadviseur
behoefte analyse=behoefteanalyse
intake afspraak=intakeafspraak
boete oplegging=boeteoplegging
knie artrose=knieartrose
radio actiever=radioactiever
justitie ambtenaren=justitieambtenaren
mode academie=modeacademie
studie opdrachten=studieopdrachten
informatie aanvraag=informatieaanvraag
toe name=toename
web only=webonly
play off=playoff
all inclusive=all-inclusive
quick scan=quickscan
know how=knowhow
dien tengevolge=dientengevolge
adams kostuum=adamskostuum
zee anemoon=zeeanemoon
exploitatie opzet=exploitatieopzet
organisatie opstellingen=organisatieopstellingen
emissie arm=emissiearm
controle arts=controlearts
studio albums=studioalbums
extra ordinaire=extraordinaire
reclame advertenties=reclameadvertenties
vakantie aanbod=vakantieaanbod
website adres=websiteadres
gemeente architect=gemeentearchitect
foto apparaat=fotoapparaat
mede ondertekend=medeondertekend
pizza ovens=pizzaovens
geboorte akten=geboorteakten
octrooi aanvragen=octrooiaanvragen
bagage afhandeling=bagageafhandeling
productie orders=productieorders
software applicaties=softwareapplicaties
controle afspraak=controleafspraak
controle acties=controleacties
octrooi aanvraag=octrooiaanvraag
college akkoord=collegeakkoord
radio aanbod=radioaanbod
keuze opties=keuzeopties
preventie acties=preventieacties
controle opdrachten=controleopdrachten
regie aanwijzingen=regieaanwijzingen
gemeente archieven=gemeentearchieven
diagnose apparatuur=diagnoseapparatuur
live optreden=liveoptreden
secretaresse opleiding=secretaresseopleiding
consumptie artikelen=consumptieartikelen
ei afzet=eiafzet
organisatie opzet=organisatieopzet
promotie organisatie=promotieorganisatie
micro array=microarray
strooi acties=strooiacties
subsidie afspraken=subsidieafspraken
auto assemblage=autoassemblage
bagage opslag=bagageopslag
advertentie acquisitie=advertentieacquisitie
accu oplader=accuoplader
productie ontwikkeling=productieontwikkeling
theorie opleiding=theorieopleiding
zee oorlogen=zeeoorlogen
software octrooien=softwareoctrooien
advertentie afdeling=advertentieafdeling
airco apparatuur=aircoapparatuur
communicatie adviezen=communicatieadviezen
suppletie aangifte=suppletieaangifte
reparatie opdracht=reparatieopdracht
controle organisatie=controleorganisatie
competitie avonden=competitieavonden
energie adviezen=energieadviezen
referentie adres=referentieadres
milieu adviseurs=milieuadviseurs
registratie autoriteiten=registratieautoriteiten
plantage arbeiders=plantagearbeiders
politie optredens=politieoptredens
ski ongeval=skiongeval
vakantie album=vakantiealbum
video archief=videoarchief
knie actie=knieactie
inflatie ontwikkeling=inflatieontwikkeling
olie aandelen=olieaandelen
milieu aansprakelijkheid=milieuaansprakelijkheid
lawaai optocht=lawaaioptocht
ere afdeling=ereafdeling
reductie afspraken=reductieafspraken
vakantie adresje=vakantieadresje
pre order=preorder
integratie oplossingen=integratieoplossingen
productie overschot=productieoverschot
installatie afspraak=installatieafspraak
po[ëzie albums=po[ëziealbums
premie opbrengsten=premieopbrengsten
organisatie opstelling=organisatieopstelling
massa organisaties=massaorganisaties
mee aten=meeaten
bio accumulatie=bioaccumulatie
installatie automaten=installatieautomaten
locatie aanduiding=locatieaanduiding
informatie oorlog=informatieoorlog
micro ampère=microampère
kantine aanbod=kantineaanbod
mede opsteller=medeopsteller
expertise ontwikkeling=expertiseontwikkeling
politie autoriteiten=politieautoriteiten
ski oorden=skioorden
vacature aanbod=vacatureaanbod
heide ontginningen=heideontginningen
scenario analyses=scenarioanalyses
warmte overdracht=warmteoverdracht
informatie aanbod=informatieaanbod
taxi oorlog=taxioorlog
telefonie aanbieder=telefonieaanbieder
selectie advies=selectieadvies
preventie adviseurs=preventieadviseurs
gemeente archivaris=gemeentearchivaris
foto avonden=fotoavonden
controle actie=controleactie
wiskunde onderwijs=wiskundeonderwijs
ventilatie opening=ventilatieopening
informatie analyse=informatieanalyse
innovatie agenda=innovatieagenda
harmonie orkesten=harmonieorkesten
adoptie ouder=adoptieouder
restauratie atelier=restauratieatelier
hitte ontwikkeling=hitteontwikkeling
garantie aanvraag=garantieaanvraag
exploitatie activiteiten=exploitatieactiviteiten
pagina opbouw=paginaopbouw
gemeente arbeider=gemeentearbeider
gemeente arts=gemeentearts
hetero anamnese=heteroanamnese
olie aanvoer=olieaanvoer
mode assortiment=modeassortiment
machine operator=machineoperator
media ontwikkelingen=mediaontwikkelingen
zwakte analyse=zwakteanalyse
symmetrie as=symmetrieas
fusie overleg=fusieoverleg
klei aarde=kleiaarde
yoga opleiding=yogaopleiding
prestige objecten=prestigeobjecten
ziekte overdracht=ziekteoverdracht
reanimatie onderwijs=reanimatieonderwijs
branche afspraken=brancheafspraken
torsie as=torsieas
waarde overzicht=waardeoverzicht
politie afdeling=politieafdeling
referentie ontwerp=referentieontwerp
ski ongeluk=skiongeluk
politie agenten=politieagenten
indicatie orgaan=indicatieorgaan
compositie opdrachten=compositieopdrachten
solo album=soloalbum
meditatie avonden=meditatieavonden
interactie ontwerp=interactieontwerp
olie opslag=olieopslag
milieu aspect=milieuaspect
productie apparaat=productieapparaat
franchise organisatie=franchiseorganisatie
menu optie=menuoptie
retro actief=retroactief
communicatie activiteiten=communicatieactiviteiten
milieu onvriendelijke=milieuonvriendelijke
studie adviseur=studieadviseur
symfonie orkesten=symfonieorkesten
koffie ochtend=koffieochtend
zee arenden=zeearenden
productie omgevingen=productieomgevingen
foto afdrukken=fotoafdrukken
referentie architectuur=referentiearchitectuur
indicatie organen=indicatieorganen
politie ambtenaar=politieambtenaar
repetitie avond=repetitieavond
hypo allergene=hypoallergene
gemeente avond=gemeenteavond
mode accessoires=modeaccessoires
functie omschrijvingen=functieomschrijvingen
tri atleten=triatleten
geboorte overschot=geboorteoverschot
pre advies=preadvies
bingo avond=bingoavond
milieu onvriendelijk=milieuonvriendelijk
montage afdeling=montageafdeling
zee armen=zeearmen
productie omstandigheden=productieomstandigheden
kraai achtigen=kraaiachtigen
familie album=familiealbum
schade afwikkeling=schadeafwikkeling
pizza oven=pizzaoven
mede auteur=medeauteur
operatie assistenten=operatieassistenten
risico aansprakelijkheid=risicoaansprakelijkheid
vakantie adressen=vakantieadressen
detentie omstandigheden=detentieomstandigheden
trauma opvang=traumaopvang
productie order=productieorder
populatie ontwikkeling=populatieontwikkeling
luxe auto's=luxeauto's
fractie assistent=fractieassistent
milieu aanvraag=milieuaanvraag
televisie aanbieders=televisieaanbieders
software ontwerp=softwareontwerp
gemeente avonden=gemeenteavonden
informatie opdracht=informatieopdracht
subsidie ontvanger=subsidieontvanger
centi aren=centiaren
media optreden=mediaoptreden
procedure afspraken=procedureafspraken
redactie adres=redactieadres
rotatie as=rotatieas
sollicitatie activiteiten=sollicitatieactiviteiten
technologie aandelen=technologieaandelen
concurrentie overwegingen=concurrentieoverwegingen
energie advies=energieadvies
milieu overwegingen=milieuoverwegingen
politie agente=politieagente
productie activiteiten=productieactiviteiten
energie opbrengst=energieopbrengst
type aanduiding=typeaanduiding
stage opdracht=stageopdracht
organisatie adviseurs=organisatieadviseurs
software oplossing=softwareoplossing
politie academie=politieacademie
fase overgangen=faseovergangen
warmte afvoer=warmteafvoer
defensie apparaat=defensieapparaat
groei aandelen=groeiaandelen
re affectatie=reaffectatie
foto academie=fotoacademie
giro afschriften=giroafschriften
groei ontwikkeling=groeiontwikkeling
familie anamnese=familieanamnese
psycho analyticus=psychoanalyticus
programma overzicht=programmaoverzicht
recreatie oord=recreatieoord
lengte as=lengteas
studie object=studieobject
software ontwikkelaar=softwareontwikkelaar
energie akkoord=energieakkoord
foto apparatuur=fotoapparatuur
yoga oefeningen=yogaoefeningen
info avonden=infoavonden
massa ontslag=massaontslag
stage opdrachten=stageopdrachten
promotie activiteiten=promotieactiviteiten
vakantie opvang=vakantieopvang
competentie ontwikkeling=competentieontwikkeling
video animatie=videoanimatie
medicatie overzicht=medicatieoverzicht
service organisatie=serviceorganisatie
high tech=hightech
milieu effect=milieueffect
detectie apparatuur=detectieapparatuur
audio apparatuur=audioapparatuur
zee aquarium=zeeaquarium
naai ateliers=naaiateliers
controle aspect=controleaspect
radio amateurs=radioamateurs
koffie ochtenden=koffieochtenden
solo artiest=soloartiest
revalidatie artsen=revalidatieartsen
familie opstelling=familieopstelling
vakantie appartement=vakantieappartement
televisie optredens=televisieoptredens
productie afdelingen=productieafdelingen
functie aanduiding=functieaanduiding
ski oord=skioord
milieu ambtenaren=milieuambtenaren
sim only=simonly
soja olie=sojaolie
studio album=studioalbum
video apparatuur=videoapparatuur
software ontwikkelaars=softwareontwikkelaars
politie actie=politieactie
communicatie adviseurs=communicatieadviseurs
rente opslag=renteopslag
vakantie activiteiten=vakantieactiviteiten
vee artsen=veeartsen
communicatie apparatuur=communicatieapparatuur
milieu educatie=milieueducatie
politie organisatie=politieorganisatie
preventie adviseur=preventieadviseur
organisatie advies=organisatieadvies
studie advies=studieadvies
navigatie apparatuur=navigatieapparatuur
communicatie advies=communicatieadvies
familie opstellingen=familieopstellingen
visie ontwikkeling=visieontwikkeling
calorie arme=caloriearme
pre operatief=preoperatief
waarde overdracht=waardeoverdracht
geboorte afwijkingen=geboorteafwijkingen
re activatie=reactivatie
hooi opslag=hooiopslag
energie overdracht=energieoverdracht
zonne activiteit=zonneactiviteit
politie agentje=politieagentje
schade afhandeling=schadeafhandeling
zee arm=zeearm
mode ontwerpster=modeontwerpster
geboorte aangifte=geboorteaangifte
epilepsie aanval=epilepsieaanval
communicatie afdeling=communicatieafdeling
mode accessoire=modeaccessoire
woede aanvallen=woedeaanvallen
software oplossingen=softwareoplossingen
race auto's=raceauto's
tri ootje=triootje
tri atleet=triatleet
charme offensief=charmeoffensief
balsamico azijn=balsamicoazijn
opinie artikel=opinieartikel
service afdeling=serviceafdeling
koffie automaten=koffieautomaten
knie operatie=knieoperatie
politie apparaat=politieapparaat
co axiale=coaxiale
grootte orde=grootteorde
groei ambities=groeiambities
mede organisator=medeorganisator
warmte opbrengst=warmteopbrengst
vanwaarde verklaring=vanwaardeverklaring
home audio=homeaudio
functie opleiding=functieopleiding
productie aanleg=productieaanleg
visualisatie oefening=visualisatieoefening
video apparaat=videoapparaat
chocolade atelier=chocoladeatelier
software aanpassing=softwareaanpassing
energie ambassadeurs=energieambassadeurs
hardware ondersteuning=hardwareondersteuning
reclame opdrachten=reclameopdrachten
gemeente ontvangers=gemeenteontvangers
fraude opsporing=fraudeopsporing
fraude afdeling=fraudeafdeling
familie auto's=familieauto's
draai assen=draaiassen
mede overheid=medeoverheid
rente afspraken=renteafspraken
referentie opdracht=referentieopdracht
reclame aanbod=reclameaanbod
gemeente advocaat=gemeenteadvocaat
gemeente asiel=gemeenteasiel
premie aanvrager=premieaanvrager
marine arts=marinearts
vakantie ontbijt=vakantieontbijt
vakantie artikel=vakantieartikel
vakantie aanspraak=vakantieaanspraak
gemeente apparaat=gemeenteapparaat
urine afname=urineafname
toernooi organisatoren=toernooiorganisatoren
thee apparatuur=theeapparatuur
adoptie organisatie=adoptieorganisatie
schade analyse=schadeanalyse
gloei oven=gloeioven
promotie opleiding=promotieopleiding
ultra orthodoxen=ultraorthodoxen
foto amateurs=fotoamateurs
service opdrachten=serviceopdrachten
advertentie opdrachten=advertentieopdrachten
exploitatie overzichten=exploitatieoverzichten
familie advertenties=familieadvertenties
fase onderhoud=faseonderhoud
fraude affaire=fraudeaffaire
programma overzichten=programmaoverzichten
productie assistente=productieassistente
garantie afspraken=garantieafspraken
promotie album=promotiealbum
reclame artikel=reclameartikel
software ondersteuning=softwareondersteuning
stage aanbod=stageaanbod
separatie angst=separatieangst
service afdelingen=serviceafdelingen
fotografie opdracht=fotografieopdracht
fotografie opleiding=fotografieopleiding
oranje appel=oranjeappel
rente aandeel=renteaandeel
advertentie aanbod=advertentieaanbod
cadeau abonnement=cadeauabonnement
graffiti artiesten=graffitiartiesten
familie overlevering=familieoverlevering
energie opbrengsten=energieopbrengsten
ere ambt=ereambt
theologie opleiding=theologieopleiding
speculatie object=speculatieobject
regio avond=regioavond
rente aanpassing=renteaanpassing
urine onderzoeken=urineonderzoeken
routine onderhoud=routineonderhoud
radio activiteiten=radioactiviteiten
energie absorptie=energieabsorptie
energie opbouw=energieopbouw
heide ontwikkeling=heideontwikkeling
restauratie ateliers=restauratieateliers
auto advertenties=autoadvertenties
vacature omschrijving=vacatureomschrijving
preventie assistentes=preventieassistentes
route advies=routeadvies
rente afdekking=renteafdekking
risico afwegingen=risicoafwegingen
risico activiteiten=risicoactiviteiten
preventie actie=preventieactie
familie oudste=familieoudste
lease oplossing=leaseoplossing
garde officier=gardeofficier
toernooi opzet=toernooiopzet
bi atlete=biatlete
redactie agenda=redactieagenda
productie oplossingen=productieoplossingen
artillerie officier=artillerieofficier
parochie archieven=parochiearchieven
data ontsluiting=dataontsluiting
data ontvangst=dataontvangst
depressie activiteit=depressieactiviteit
commissie advies=commissieadvies
communicatie oorlog=communicatieoorlog
montage ankers=montageankers
geboorte aangiftes=geboorteaangiftes
televisie abonnementen=televisieabonnementen
selectie assessment=selectieassessment
milli ampères=milliampères
software afdeling=softwareafdeling
productie areaal=productieareaal
productie ateliers=productieateliers
quarantaine organisme=quarantaineorganisme
radio actie=radioactie
presentatie avonden=presentatieavonden
radio avontuur=radioavontuur
vakantie avontuur=vakantieavontuur
douane aangelegenheden=douaneaangelegenheden
competentie analyse=competentieanalyse
transactie aantallen=transactieaantallen
stabilisatie operaties=stabilisatieoperaties
conditie achterstand=conditieachterstand
toerisme organisatie=toerismeorganisatie
rente aflossing=renteaflossing
geboorte aankondigingen=geboorteaankondigingen
grammatica oefeningen=grammaticaoefeningen
haai aanval=haaiaanval
sauna ovens=saunaovens
parochie avond=parochieavond
hardware adres=hardwareadres
milieu experts=milieuexperts
lawaai acties=lawaaiacties
integratie ambtenaar=integratieambtenaar
lente actie=lenteactie
communicatie apparaten=communicatieapparaten
studio appartement=studioappartement
software analyse=softwareanalyse
carrosserie afdeling=carrosserieafdeling
constructie advies=constructieadvies
valuta ontwikkelingen=valutaontwikkelingen
video analist=videoanalist
hooi oppers=hooioppers
sensibilisatie acties=sensibilisatieacties
functie ontwikkeling=functieontwikkeling
formule ontwikkeling=formuleontwikkeling
groei afwijking=groeiafwijking
halte afstanden=halteafstanden
ski ongevallen=skiongevallen
service oplossing=serviceoplossing
serie opname=serieopname
energie afnemers=energieafnemers
technologie ontwikkelingen=technologieontwikkelingen
infra orde=infraorde
taxi apparatuur=taxiapparatuur
tarwe opbrengst=tarweopbrengst
tempo aanduiding=tempoaanduiding
programma opbouw=programmaopbouw
lease oplossingen=leaseoplossingen
homo adoptie=homoadoptie
risico atlas=risicoatlas
gemeente afdelingen=gemeenteafdelingen
formatie akkoord=formatieakkoord
vagina opening=vaginaopening
therapie advies=therapieadvies
reparatie activiteiten=reparatieactiviteiten
therapie opleiding=therapieopleiding
productie optimalisatie=productieoptimalisatie
competentie agenda=competentieagenda
productie aanbod=productieaanbod
hoogte afstelling=hoogteafstelling
portefeuille overzicht=portefeuilleoverzicht
acquisitie activiteiten=acquisitieactiviteiten
behoefte analyses=behoefteanalyses
retentie apparatuur=retentieapparatuur
rente ontvangsten=renteontvangsten
revisie operatie=revisieoperatie
politie administratie=politieadministratie
risico aanpak=risicoaanpak
routine activiteiten=routineactiviteiten
reclame aanbiedingen=reclameaanbiedingen
reclame offensief=reclameoffensief
recreatie object=recreatieobject
recreatie omgeving=recreatieomgeving
theorie onderwijs=theorieonderwijs
tele onthaal=teleonthaal
draai avond=draaiavond
sperma oorlog=spermaoorlog
telefonie oplossingen=telefonieoplossingen
politie operaties=politieoperaties
premie ontvangsten=premieontvangsten
premie opbrengst=premieopbrengst
regie orgaan=regieorgaan
quarantaine organismen=quarantaineorganismen
urgentie aanvraag=urgentieaanvraag
vakantie aanbiedingen=vakantieaanbiedingen
reclame affiche=reclameaffiche
auto accu's=autoaccu's
benzine accijnzen=benzineaccijnzen
cocaïne affaire=cocaïneaffaire
subsidie afbouw=subsidieafbouw
theorie opleidingen=theorieopleidingen
snoei advies=snoeiadvies
administratie afdeling=administratieafdeling
installatie advies=installatieadvies
zonne auto's=zonneauto's
theorie ontwikkeling=theorieontwikkeling
migratie aanpak=migratieaanpak
klei afzetting=kleiafzetting
lente offensief=lenteoffensief
roze achtige=rozeachtige
simulatie oefening=simulatieoefening
service aanvraag=serviceaanvraag
solo apparatuur=soloapparatuur
telefonie aanbieders=telefonieaanbieders
telefonie abonnement=telefonieabonnement
olie afhankelijkheid=olieafhankelijkheid
media opdracht=mediaopdracht
live act=liveact
douane administratie=douaneadministratie
maai afval=maaiafval
maffia organisatie=maffiaorganisatie
massa opbouw=massaopbouw
glucose oplossing=glucoseoplossing
micro alg=microalg
projectie apparatuur=projectieapparatuur
defensie order=defensieorder
na opvang=naopvang
entree opleidingen=entreeopleidingen
ziekte oorzaak=ziekteoorzaak
evaluatie avond=evaluatieavond
exploitatie overschotten=exploitatieoverschotten
gilde activiteiten=gildeactiviteiten
participatie orgaan=participatieorgaan
opname avond=opnameavond
reclame aanpak=reclameaanpak
pre orders=preorders
estafette acties=estafetteacties
energie ontwikkeling=energieontwikkeling
exploitatie opbrengsten=exploitatieopbrengsten
februari ochtend=februariochtend
gemeente adviseur=gemeenteadviseur
elektro akoestische=elektroakoestische
energie activiteiten=energieactiviteiten
televisie activiteiten=televisieactiviteiten
energie aftrek=energieaftrek
olie opbrengst=olieopbrengst
holte ontsteking=holteontsteking
constructie opbouw=constructieopbouw
geboorte aangiften=geboorteaangiften
micro architectuur=microarchitectuur
idee ontwikkeling=ideeontwikkeling
waarde ori[ëntaties=waardeori[ëntaties
media orgaan=mediaorgaan
productie advies=productieadvies
productie opdracht=productieopdracht
communicatie actie=communicatieactie
renovatie opgave=renovatieopgave
hifi apparatuur=hifiapparatuur
hitte alarm=hittealarm
armoede overleg=armoedeoverleg
energie oplossing=energieoplossing
milieu aantasting=milieuaantasting
mee ondertekend=meeondertekend
actie organisatie=actieorganisatie
ruimte objecten=ruimteobjecten
software aanpassingen=softwareaanpassingen
juni avond=juniavond
introductie activiteiten=introductieactiviteiten
video animaties=videoanimaties
geboorte aankondiging=geboorteaankondiging
olie aanbod=olieaanbod
branche opleidingen=brancheopleidingen
principe aanvraag=principeaanvraag
koffie afspraak=koffieafspraak
productie arbeid=productiearbeid
vakantie ouders=vakantieouders
meditatie object=meditatieobject
applicatie omgeving=applicatieomgeving
waarde aandelen=waardeaandelen
montage apparatuur=montageapparatuur
stage organisatie=stageorganisatie
installatie adviseurs=installatieadviseurs
referentie adressen=referentieadressen
innovatie adviseurs=innovatieadviseurs
osteo artrose=osteoartrose
innovatie afdeling=innovatieafdeling
insuline afhankelijke=insulineafhankelijke
koude opwekking=koudeopwekking
savanne olifant=savanneolifant
analyse apparaat=analyseapparaat
mode academies=modeacademies
keuze afstanden=keuzeafstanden
televisie aansluitingen=televisieaansluitingen
regio activiteiten=regioactiviteiten
reparatie opdrachten=reparatieopdrachten
vakantie avonturen=vakantieavonturen
configuratie opties=configuratieopties
kamikaze actie=kamikazeactie
immigratie autoriteiten=immigratieautoriteiten
waarde ori[ëntatie=waardeori[ëntatie
vegetatie opnames=vegetatieopnames
informatie omgeving=informatieomgeving
agenda overzicht=agendaoverzicht
asperge oogst=aspergeoogst
navigatie apparaten=navigatieapparaten
controle afdeling=controleafdeling
doe opdrachten=doeopdrachten
douane activiteiten=douaneactiviteiten
douche afvoer=doucheafvoer
chemie onderwijs=chemieonderwijs
mede aansprakelijkheid=medeaansprakelijkheid
sirene actie=sireneactie
vakantie aanspraken=vakantieaanspraken
ventilatie oplossingen=ventilatieoplossingen
bloei aar=bloeiaar
vaccinatie advies=vaccinatieadvies
educatie aanbod=educatieaanbod
concentratie oefening=concentratieoefening
navigatie adres=navigatieadres
directie assistent=directieassistent
justitie assistenten=justitieassistenten
milieu archief=milieuarchief
lease optie=leaseoptie
imago advies=imagoadvies
warmte onweer=warmteonweer
corruptie affaire=corruptieaffaire
indicatie aanvraag=indicatieaanvraag
koffie adres=koffieadres
sauna oven=saunaoven
innovatie agenda's=innovatieagenda's
organisatie analyse=organisatieanalyse
productie arbeiders=productiearbeiders
race activiteiten=raceactiviteiten
race afstand=raceafstand
organisatie aanpassingen=organisatieaanpassingen
routine operatie=routineoperatie
combi ovens=combiovens
directie adviseur=directieadviseur
sabotage actie=sabotageactie
naturalisatie aanvraag=naturalisatieaanvraag
mede ontwerper=medeontwerper
emissie autoriteit=emissieautoriteit
etappe overwinningen=etappeoverwinningen
grootte ordes=grootteordes
garantie aanspraak=garantieaanspraak
evaluatie opdracht=evaluatieopdracht
familie attracties=familieattracties
risico aspecten=risicoaspecten
tarwe areaal=tarweareaal
mei avond=meiavond
ruimte overwicht=ruimteoverwicht
mime opleiding=mimeopleiding
integratie activiteiten=integratieactiviteiten
energie afname=energieafname
valuta oorlogen=valutaoorlogen
tango avond=tangoavond
politie archief=politiearchief
energie aansluitingen=energieaansluitingen
televisie aanbieder=televisieaanbieder
televisie antennes=televisieantennes
douane aangiftes=douaneaangiftes
drama oefeningen=dramaoefeningen
fantasie opstelling=fantasieopstelling
regie organen=regieorganen
drie assers=drieassers
vitamine arme=vitaminearme
gilde avond=gildeavond
thee aanslag=theeaanslag
energie analyse=energieanalyse
expertise opdracht=expertiseopdracht
operatie advies=operatieadvies
relaxatie oefening=relaxatieoefening
reclame afbeeldingen=reclameafbeeldingen
navigatie app=navigatieapp
reclame advertentie=reclameadvertentie
peri operatief=perioperatief
heide achtigen=heideachtigen
competentie onderwijs=competentieonderwijs
psychologie opleidingen=psychologieopleidingen
propositie ontwikkeling=propositieontwikkeling
propaganda offensief=propagandaoffensief
prooi overdracht=prooioverdracht
twee assers=tweeassers
fractie ondersteuner=fractieondersteuner
promotie organisaties=promotieorganisaties
aanziens des=aanzien des
energie administratie=energieadministratie
zee oor=zeeoor
bio afbreekbare=bioafbreekbare
olie advies=olieadvies
emissie opbrengst=emissieopbrengst
collectie opstelling=collectieopstelling
high heels=hoge hakken
er vanuitgaande=ervan uitgaande
ooit meer=nooit meer
mini onderzee[ër=minionderzee[ër
tot voorkort=tot voor kort
op steenworpafstand=op een steenworp afstand
warmte afname=warmteafname
database objecten=databaseobjecten
recherche officier=rechercheofficier
draai armen=draaiarmen
foto app=fotoapp
bureau artikelen=bureauartikelen
espresso apparatuur=espressoapparatuur
programma omgeving=programmaomgeving
blokkade actie=blokkadeactie
mede arbeider=medearbeider
montage activiteiten=montageactiviteiten
milieu overweging=milieuoverweging
milieu audit=milieuaudit
milieu akkoorden=milieuakkoorden
milieu aanpak=milieuaanpak
medicatie overzichten=medicatieoverzichten
medicatie opdracht=medicatieopdracht
medicatie advies=medicatieadvies
massage opleiding=massageopleiding
locatie analyse=locatieanalyse
navigatie opties=navigatieopties
online omgeving=onlineomgeving
groente orkest=groenteorkest
groente assortiment=groenteassortiment
gilde attributen=gildeattributen
gilde archief=gildearchief
hardware ontwikkeling=hardwareontwikkeling
observatie actie=observatieactie
octrooi aftrek=octrooiaftrek
ambulance auto=ambulanceauto
productie overzichten=productieoverzichten
advertentie afdelingen=advertentieafdelingen
productie aandeel=productieaandeel
participatie organen=participatieorganen
parochie assistente=parochieassistente
parochie assistent=parochieassistent
fusie akte=fusieakte
hoogte aanpassing=hoogteaanpassing
strooi auto=strooiauto
gemeente opzichter=gemeenteopzichter
urine opening=urineopening
transitie arena=transitiearena
vee auto's=veeauto's
isolatie oefeningen=isolatieoefeningen
innovatie organisatie=innovatieorganisatie
hardware oplossingen=hardwareoplossingen
familie ontbijt=familieontbijt
programma ondersteuning=programmaondersteuning
horeca overleg=horecaoverleg
organisatie advisering=organisatieadvisering
mode ateliers=modeateliers
zonne ovens=zonneovens
oranje appels=oranjeappels
file aanpak=fileaanpak
breedte aankoop=breedteaankoop
zee appels=zeeappels
camera opnamen=cameraopnamen
risico avers=risicoavers
energie afhankelijk=energieafhankelijk
horeca ontwikkeling=horecaontwikkeling
educatie afdeling=educatieafdeling
keuze oefening=keuzeoefening
carrière adviezen=carrièreadviezen
game avondje=gameavondje
chemie aandeel=chemieaandeel
insuline afhankelijk=insulineafhankelijk
branche oplossingen=brancheoplossingen
douane agenten=douaneagenten
keuze activiteit=keuzeactiviteit
referentie aanbod=referentieaanbod
hooi opbrengst=hooiopbrengst
diepte alarm=dieptealarm
kantine opbrengsten=kantineopbrengsten
functie onderhoud=functieonderhoud
indicatie adviseur=indicatieadviseur
prestatie ontwikkeling=prestatieontwikkeling
productie administratie=productieadministratie
regio adviseurs=regioadviseurs
promotie opleidingen=promotieopleidingen
poesie albums=poesiealbums
politie agentjes=politieagentjes
premie aanpassingen=premieaanpassingen
presentatie angst=presentatieangst
presentatie opdracht=presentatieopdracht
innovatie aanpak=innovatieaanpak
functie aanpassing=functieaanpassing
isolatie oplossing=isolatieoplossing
game ontwerpers=gameontwerpers
ziekte attest=ziekteattest
groei impuls=groeiimpuls
folie opdruk=folieopdruk
formatie opbouw=formatieopbouw
foto analyse=fotoanalyse
fractie opvolger=fractieopvolger
politie opdrachten=politieopdrachten
lease aanbod=leaseaanbod
homo ambassadeur=homoambassadeur
familie appartementen=familieappartementen
defensie activiteiten=defensieactiviteiten
elite agent=eliteagent
boete oplegger=boeteoplegger
zee oren=zeeoren
exploratie activiteiten=exploratieactiviteiten
twee asser=tweeasser
informatica opleidingen=informaticaopleidingen
controle aspecten=controleaspecten
contributie afdracht=contributieafdracht
energie overschotten=energieoverschotten
directie archief=directiearchief
communicatie oefeningen=communicatieoefeningen
koffie ontvangst=koffieontvangst
distributie afdeling=distributieafdeling
zee ijs=zeeijs
corruptie affaires=corruptieaffaires
familie appartement=familieappartement
coördinatie organen=coördinatieorganen
coördinatie opdracht=coördinatieopdracht
encryptie algoritme=encryptiealgoritme
resistentie opbouw=resistentieopbouw
zaai ui=zaaiui
douche oplossingen=doucheoplossingen
calorie armer=caloriearmer
trapeze act=trapezeact
concessie opdrachten=concessieopdrachten
fotografie opdrachten=fotografieopdrachten
improvisatie opdracht=improvisatieopdracht
selectie opdrachten=selectieopdrachten
restauratie opdracht=restauratieopdracht
drie assig=drieassig
echo afbeelding=echoafbeelding
interactie ontwerpers=interactieontwerpers
pauze activiteit=pauzeactiviteit
warmte aanbod=warmteaanbod
zee alg=zeealg
pagina overzicht=paginaoverzicht
demo avond=demoavond
foto activiteit=fotoactiviteit
warmte afnemers=warmteafnemers
intro avond=introavond
fusie aanvraag=fusieaanvraag
mandoline orkest=mandolineorkest
transactie aanbod=transactieaanbod
mega opdracht=megaopdracht
consumptie afval=consumptieafval
radio astronomen=radioastronomen
controle audits=controleaudits
route optimalisatie=routeoptimalisatie
stage aanbieder=stageaanbieder
commissie agenda=commissieagenda
gemeente archeoloog=gemeentearcheoloog
milieu activiteit=milieuactiviteit
medicatie afhankelijke=medicatieafhankelijke
vakantie organisatie=vakantieorganisatie
media overzicht=mediaoverzicht
media opleidingen=mediaopleidingen
website activiteit=websiteactiviteit
radio archief=radioarchief
route aanduidingen=routeaanduidingen
locatie ontwikkelingen=locatieontwikkelingen
olie afval=olieafval
informatie afdeling=informatieafdeling
niveau anci[ënniteit=niveauanci[ënniteit
revalidatie afdelingen=revalidatieafdelingen
implementatie agenda=implementatieagenda
zee asters=zeeasters
keuze opdracht=keuzeopdracht
frustratie agressie=frustratieagressie
portefeuille overdracht=portefeuilleoverdracht
innovatie arrangement=innovatiearrangement
race afdeling=raceafdeling
locatie aanduidingen=locatieaanduidingen
maffia oorlog=maffiaoorlog
ruimte auto=ruimteauto
wiskunde olympiade=wiskundeolympiade
functie aspecten=functieaspecten
thema ochtenden=themaochtenden
service aspecten=serviceaspecten
menu opdrachten=menuopdrachten
ratio analyse=ratioanalyse
inspiratie avonden=inspiratieavonden
cargo afdeling=cargoafdeling
website ontwikkelaar=websiteontwikkelaar
echo apparaten=echoapparaten
implementatie aspecten=implementatieaspecten
lengte assen=lengteassen
lease aanvraag=leaseaanvraag
service ondersteuning=serviceondersteuning
reactie omstandigheden=reactieomstandigheden
solo acties=soloacties
mini advertentie=miniadvertentie
sproei apparaat=sproeiapparaat
isolatie afstand=isolatieafstand
campagne avond=campagneavond
categorie aanduiding=categorieaanduiding
semi autonome=semiautonome
servo aandrijvingen=servoaandrijvingen
compensatie opgave=compensatieopgave
ski afstand=skiafstand
campagne aanpak=campagneaanpak
radio avond=radioavond
familie arrangement=familiearrangement
hygi[ëne adviezen=hygi[ëneadviezen
opname afdelingen=opnameafdelingen
kantine afval=kantineafval
ruimte avonturen=ruimteavonturen
reclame adviseur=reclameadviseur
commissie overleg=commissieoverleg
situatie afhankelijke=situatieafhankelijke
prooi aanbod=prooiaanbod
promotie afdeling=promotieafdeling
registratie apparaat=registratieapparaat
coalitie afspraak=coalitieafspraak
arrestatie actie=arrestatieactie
applicatie ontwerp=applicatieontwerp
animatie afdeling=animatieafdeling
animatie aanbod=animatieaanbod
correspondentie adressen=correspondentieadressen
sterilisatie afdeling=sterilisatieafdeling
productie opbrengst=productieopbrengst
milieu overheden=milieuoverheden
sanctie arsenaal=sanctiearsenaal
tarwe aar=tarweaar
subsidie overzicht=subsidieoverzicht
studie orgaan=studieorgaan
studie optie=studieoptie
solo artieste=soloartieste
schade aanspraken=schadeaanspraken
lawaai actie=lawaaiactie
lease adviseurs=leaseadviseurs
risico adres=risicoadres
premie overzicht=premieoverzicht
service afspraak=serviceafspraak
service aanbiedingen=serviceaanbiedingen
exploitatie opzetten=exploitatieopzetten
productie afspraak=productieafspraak
energie afnemer=energieafnemer
foto afbeeldingen=fotoafbeeldingen
route ontwerp=routeontwerp
pagina ontwerp=paginaontwerp
premie opslagen=premieopslagen
studie orkest=studieorkest
premie opbouw=premieopbouw
auto airco=autoairco
pauze act=pauzeact
alimentatie ontvanger=alimentatieontvanger
elektro auto=elektroauto
adoptie organisaties=adoptieorganisaties
benzine aansteker=benzineaansteker
navigatie oplossing=navigatieoplossing
service oplossingen=serviceoplossingen
subsidie afrekeningen=subsidieafrekeningen
live acts=liveacts
waarde analyse=waardeanalyse
software architecten=softwarearchitecten
programma opzet=programmaopzet
promo acties=promoacties
improvisatie oefeningen=improvisatieoefeningen
artillerie aanval=artillerieaanval
foto applicatie=fotoapplicatie
branche aanpak=brancheaanpak
torpedo aanval=torpedoaanval
klei ontginning=kleiontginning
technologie aanbieders=technologieaanbieders
trapeze artiest=trapezeartiest
urgentie artsen=urgentieartsen
sollicitatie advies=sollicitatieadvies
toernooi organisator=toernooiorganisator
maai arm=maaiarm
tri atletes=triatletes
televisie ontvanger=televisieontvanger
telefonie apparatuur=telefonieapparatuur
marge ontwikkeling=margeontwikkeling
mode ontwerpsters=modeontwerpsters
camera opnames=cameraopnames
douane administraties=douaneadministraties
controle autoriteit=controleautoriteit
concurrentie autoriteiten=concurrentieautoriteiten
compressie algoritme=compressiealgoritme
documentatie afdeling=documentatieafdeling
discussie overzicht=discussieoverzicht
periode afsluiting=periodeafsluiting
peri orale=periorale
risico aandeel=risicoaandeel
energie afrekening=energieafrekening
informatie analyses=informatieanalyses
excursie avond=excursieavond
race avond=raceavond
branche ontwikkeling=brancheontwikkeling
gemeente adviseurs=gemeenteadviseurs
soja oogst=sojaoogst
reparatie onderhoud=reparatieonderhoud
informatie ambtenaar=informatieambtenaar
bureau organisatie=bureauorganisatie
informatie aanbieders=informatieaanbieders
balie assistente=balieassistente
milieu aftrek=milieuaftrek
symmetrie assen=symmetrieassen
actie avontuur=actieavontuur
migratie agenda=migratieagenda
reactie arm=reactiearm
hoogte angst=hoogteangst
software aanbieders=softwareaanbieders
smartphone applicatie=smartphoneapplicatie
televisie acteur=televisieacteur
taxi opleiding=taxiopleiding
subsidie actie=subsidieactie
bio afbreekbaar=bioafbreekbaar
studie activiteit=studieactiviteit
metro achtige=metroachtige
expertise opbouw=expertiseopbouw
generatie armen=generatiearmen
politie aandacht=politieaandacht
geboorte artikelen=geboorteartikelen
rapportage omgeving=rapportageomgeving
race autootjes=raceautootjes
organisatie aanpassing=organisatieaanpassing
genade oord=genadeoord
compilatie albums=compilatiealbums
finale optreden=finaleoptreden
bla bla=blabla
geloof waardigheid=geloofwaardigheid
veel gehoord=veelgehoord
informatie objecten=informatieobjecten
van ouds=vanouds
nacht records=nachtrecords
buitenboord motor=buitenboordmotor
veel gehoorde=veelgehoorde
lepeltje lepeltje=lepeltjelepeltje
scheeps wereld=scheepswereld
scheeps werktuigkundige=scheepswerktuigkundige
stuur boordzijde=stuurboordzijde
nor male=normale
noor den=noorden
waar tegenover=waartegenover
te weeg=teweeg
introductie aanbieding=introductieaanbieding
weer records=weerrecords
schoor steen=schoorsteen
men sen=mensen
weer record=weerrecord
mor gens=morgens
ultra orthodox=ultraorthodox
database omgeving=databaseomgeving
decoratie artikel=decoratieartikel
defensie ambtenaar=defensieambtenaar
democratie opvatting=democratieopvatting
douche oplossing=doucheoplossing
bona fide=bonafide
lengte overwicht=lengteoverwicht
subsidie afrekening=subsidieafrekening
campagne activiteit=campagneactiviteit
nacht record=nachtrecord
competitie opener=competitieopener
vrede offer=vredeoffer
klei afgravingen=kleiafgravingen
dialyse apparatuur=dialyseapparatuur
fes tiviteit=festiviteit
commissie avond=commissieavond
simulatie omgeving=simulatieomgeving
te rug=terug
buitenboord motoren=buitenboordmotoren
te keer=tekeer
camera opties=cameraopties
toe genomen=toegenomen
scheeps wand=scheepswand
scheeps vorm=scheepsvorm
meeting points=meetingpoints
scheeps wanden=scheepswanden
plaat sen=plaatsen
scheeps werven=scheepswerven
scheeps winkel=scheepswinkel
dok ter=dokter
scheeps wrak=scheepswrak
half half=halfhalf
scheeps volk=scheepsvolk
migraine aanval=migraineaanval
actie artikel=actieartikel
informatie object=informatieobject
agar agar=agaragar
bucket list=bucketlist
zesde klasser=zesdeklasser
sint juttemis=sintjuttemis
ge hucht=gehucht
nor maal=normaal
web site=website
fes tival=festival
web server=webserver
web pagina=webpagina
support act=supportact
buitenboord beugel=buitenboordbeugel
decennia lang=decennialang
contact pagina=contactpagina
scheeps vlak=scheepsvlak
op lossing=oplossing
scheeps werf=scheepswerf
contact weerstand=contactweerstand
tus sen=tussen
support acts=supportacts
meeting point=meetingpoint
bling bling=blingbling
web applicatie=webapplicatie
mor gen=morgen
bak boordzijde=bakboordzijde
de ze=deze
campagne affiche=campagneaffiche
actie avond=actieavond
scheeps bouwer=scheepsbouwer
regie assistente=regieassistente
milieu administraties=milieuadministraties
restauratie afdeling=restauratieafdeling
communicatie overdracht=communicatieoverdracht
transmissie apparatuur=transmissieapparatuur
risico analisten=risicoanalisten
knie aandoeningen=knieaandoeningen
vitamine opname=vitamineopname
heide ontginning=heideontginning
improvisatie opdrachten=improvisatieopdrachten
sanctie oplegging=sanctieoplegging
migratie akkoord=migratieakkoord
subsidie oproep=subsidieoproep
televisie amusement=televisieamusement
premie aanpassing=premieaanpassing
premie offerte=premieofferte
presentatie apparatuur=presentatieapparatuur
principe akkoorden=principeakkoorden
repro afdeling=reproafdeling
sterfte overschot=sterfteoverschot
sekse operatie=sekseoperatie
frequentie afhankelijk=frequentieafhankelijk
metro aanleg=metroaanleg
service appartement=serviceappartement
zee afval=zeeafval
medicatie opdrachten=medicatieopdrachten
warmte ophoping=warmteophoping
kamille olie=kamilleolie
isolatie afstanden=isolatieafstanden
indexatie achterstand=indexatieachterstand
mode adviseur=modeadviseur
locatie afhankelijk=locatieafhankelijk
familie activiteit=familieactiviteit
mutatie analyse=mutatieanalyse
reparatie atelier=reparatieatelier
overname adviseurs=overnameadviseurs
rente overzicht=renteoverzicht
relatie advies=relatieadvies
accreditatie aanvraag=accreditatieaanvraag
collecte opbrengsten=collecteopbrengsten
reclame opdruk=reclameopdruk
schade actie=schadeactie
resolutie autoriteit=resolutieautoriteit
camera objectief=cameraobjectief
vakantie adviseurs=vakantieadviseurs
zee anker=zeeanker
accu aansluiting=accuaansluiting
barstens vol=barstensvol
risico advies=risicoadvies
koffie afval=koffieafval
visie avond=visieavond
massage apparaten=massageapparaten
acceptatie afdeling=acceptatieafdeling
massa overdracht=massaoverdracht
passe partout=passepartout
collectie overzicht=collectieoverzicht
college advies=collegeadvies
college opdrachten=collegeopdrachten
commissie adviezen=commissieadviezen
toernooi agenda=toernooiagenda
discipline overstijgend=disciplineoverstijgend
branche afspraak=brancheafspraak
bèta onderzoek=bètaonderzoek
lelie oogst=lelieoogst
hotstone massage=hotstonemassage
mede arbeiders=medearbeiders
schade advies=schadeadvies
sectie afsluiting=sectieafsluiting
milieu analyses=milieuanalyses
filosofie onderwijs=filosofieonderwijs
bossa nova=bossanova
machine automatisering=machineautomatisering
subsidie organen=subsidieorganen
suppletie advies=suppletieadvies
scenario aanpak=scenarioaanpak
service opties=serviceopties
analyse apparaten=analyseapparaten
douane operaties=douaneoperaties
keuze antwoorden=keuzeantwoorden
taxatie avond=taxatieavond
taxi organisaties=taxiorganisaties
zwaai arm=zwaaiarm
machine orders=machineorders
massage avonden=massageavonden
bagage afdekking=bagageafdekking
alinea opmaak=alineaopmaak
ten toonstelling=tentoonstelling
rechter mouw=rechtermouw
solo avontuur=soloavontuur
scheeps romp=scheepsromp
scheeps journalen=scheepsjournalen
scheeps schroeven=scheepsschroeven
ten hemelopneming=tenhemelopneming
scheeps termen=scheepstermen
ten uitvoerbrenging=tenuitvoerbrenging
scheeps timmerman=scheepstimmerman
scheeps reparatie=scheepsreparatie
scheeps resten=scheepsresten
scheeps namen=scheepsnamen
scheeps ruim=scheepsruim
radio actief=radioactief
scheeps touwen=scheepstouwen
scheeps route=scheepsroute
scheeps ladingen=scheepsladingen
scheeps lading=scheepslading
scheeps lengte=scheepslengte
scheeps officier=scheepsofficier
rechter pijp=rechterpijp
tenachter stelling=tenachterstelling
terzijde stelling=terzijdestelling
tewerk stelling=tewerkstelling
tenuitvoer brenging=tenuitvoerbrenging
pagina indeling=paginaindeling
evacuatie oefeningen=evacuatieoefeningen
data invoer=datainvoer
te naamstelling=tenaamstelling
informatie uitwisseling=informatieuitwisseling
verdacht making=verdachtmaking
tenhemel opneming=tenhemelopneming
politie agent=politieagent
informatie avond=informatieavond
scheeps routes=scheepsroutes
tenuitvoer legging=tenuitvoerlegging
risico analyse=risicoanalyse
radio actieve=radioactieve
mede oprichter=medeoprichter
scheeps papieren=scheepspapieren
scheeps installaties=scheepsinstallaties
te waterlating=tewaterlating
scheeps rompen=scheepsrompen
scheeps lieden=scheepslieden
scheeps liften=scheepsliften
scheeps jongens=scheepsjongens
scheeps naam=scheepsnaam
scheeps onderdelen=scheepsonderdelen
scheeps journaals=scheepsjournaals
scheeps kanonnen=scheepskanonnen
scheeps toeter=scheepstoeter
scheeps toeters=scheepstoeters
scheeps touw=scheepstouw
zalig verklaring=zaligverklaring
scheeps type=scheepstype
scheeps ramp=scheepsramp
scheeps ruimen=scheepsruimen
scheeps journaal=scheepsjournaal
massage olie=massageolie
tenaam stelling=tenaamstelling
foto albums=fotoalbums
scheeps timmerlieden=scheepstimmerlieden
salsa les=salsales
media industrie=mediaindustrie
scheeps reizen=scheepsreizen
tewater lating=tewaterlating
scheeps motoren=scheepsmotoren
scheeps lui=scheepslui
scheeps jongen=scheepsjongen
vankracht wording=vankrachtwording
scheeps magnaat=scheepsmagnaat
van waardeverklaring=vanwaardeverklaring
scheeps masten=scheepsmasten
scheeps kist=scheepskist
scheeps kok=scheepskok
scheeps schroef=scheepsschroef
scheeps lamp=scheepslamp
scheeps lift=scheepslift
scheeps motor=scheepsmotor
te werkstelling=tewerkstelling
scheeps timmerwerf=scheepstimmerwerf
scheeps maat=scheepsmaat
scheeps kapitein=scheepskapitein
scheeps makelaar=scheepsmakelaar
scheeps kerkhof=scheepskerkhof
scheeps model=scheepsmodel
scheeps modellen=scheepsmodellen
scheeps sloperij=scheepssloperij
scheeps industrie=scheepsindustrie
zelfstandig making=zelfstandigmaking
scheeps bouwkunde=scheepsbouwkunde
vracht wagens=vrachtwagens
tot standkoming=totstandkoming
orang oetan=orangoetan
ping pong=pingpong
duct tape=ducttape
service abonnementen=serviceabonnementen
scheeps typen=scheepstypen
leentje buur=leentjebuur
scheeps bouwindustrie=scheepsbouwindustrie
papier maché=papiermaché
ten toonstellingen=tentoonstellingen
dichtst bijzijnde=dichtstbijzijnde
spare ribs=spareribs
crowd sourcing=crowdsourcing
knock out=knockout
eerste klasser=eersteklasser
tweede klasser=tweedeklasser
derde klasser=derdeklasser
vracht wagen=vrachtwagen
was benzine=wasbenzine
vijfde klasser=vijfdeklasser
zee olifant=zeeolifant
rete goed=retegoed
in achtneming=inachtneming
scheeps uitrusting=scheepsuitrusting
tegen woordig=tegenwoordig
ten achterstelling=tenachterstelling
coalitie afspraken=coalitieafspraken
controle artsen=controleartsen
camera opstelling=cameraopstelling
website activiteiten=websiteactiviteiten
midlife crisis=midlifecrisis
website omgeving=websiteomgeving
provincie ambtenaren=provincieambtenaren
po[ëzie avonden=po[ëzieavonden
video apparaten=videoapparaten
nog maals=nogmaals
te vreden=tevreden
scheeps bouwers=scheepsbouwers
ietsie pietsie=ietsiepietsie
vierde klasser=vierdeklasser
afstands bediening=afstandsbediening
scheeps types=scheepstypes
scheeps bouwkundig=scheepsbouwkundig
scheeps hout=scheepshout
scheeps huid=scheepshuid
scheeps diesel=scheepsdiesel
scheeps huiden=scheepshuiden
scheeps bouw=scheepsbouw
scheeps jager=scheepsjager
zichtbaar making=zichtbaarmaking
teraarde bestelling=teraardebestelling
scheeps bouwkundige=scheepsbouwkundige
scheeps hoorn=scheepshoorn
scheeps bewegingen=scheepsbewegingen
scheeps beslag=scheepsbeslag
scheeps onderhoud=scheepsonderhoud
scheeps ontwerp=scheepsontwerp
foto archief=fotoarchief
scheeps rampen=scheepsrampen
naw gegevens=naw-gegevens
scheeps beschuit=scheepsbeschuit
scheeps hoorns=scheepshoorns
scheeps hond=scheepshond
poesie album=poesiealbum
scheeps containers=scheepscontainers
preventie assistente=preventieassistente
van krachtwording=vankrachtwording
scheeps bouwmeester=scheepsbouwmeester
scheeps bouwsector=scheepsbouwsector
scheeps brand=scheepsbrand
scheeps brandstof=scheepsbrandstof
scheeps brandstoffen=scheepsbrandstoffen
scheeps constructie=scheepsconstructie
scheeps dek=scheepsdek
scheeps hellingen=scheepshellingen
scheeps bouwbedrijf=scheepsbouwbedrijf
scheeps dekken=scheepsdekken
scheeps dieselmotoren=scheepsdieselmotoren
scheeps diesels=scheepsdiesels
scheeps eigenaar=scheepseigenaar
scheeps eigenaren=scheepseigenaren
scheeps gegevens=scheepsgegevens
scheeps geschut=scheepsgeschut
scheeps helling=scheepshelling
serie avonden=serieavonden
scheeps verkeer=scheepsverkeer
mode aanbod=modeaanbod
urine afvoer=urineafvoer
niveau aanduiding=niveauaanduiding
foto apparaatje=fotoapparaatje
implementatie aanpak=implementatieaanpak
indicatie advies=indicatieadvies
infanterie aanvallen=infanterieaanvallen
informatie oplossingen=informatieoplossingen
inspectie activiteiten=inspectieactiviteiten
interactie ontwerper=interactieontwerper
vakantie aanbieders=vakantieaanbieders
auto ambulances=autoambulances
vakantie atelier=vakantieatelier
precisie apparatuur=precisieapparatuur
opname apparaatje=opnameapparaatje
reparatie aanbod=reparatieaanbod
reactie armen=reactiearmen
rotatie assen=rotatieassen
drie asser=drieasser
database ontwerp=databaseontwerp
moskee organisaties=moskeeorganisaties
politie activiteiten=politieactiviteiten
justitie ambtenaar=justitieambtenaar
garantie afwikkeling=garantieafwikkeling
online aankopen=onlineaankopen
familie activiteiten=familieactiviteiten
boete opbrengsten=boeteopbrengsten
relatie ontwikkeling=relatieontwikkeling
incasso afdeling=incassoafdeling
groei echo's=groeiecho's
service onderhoud=serviceonderhoud
micro arrays=microarrays
machine operators=machineoperators
recreatie organisaties=recreatieorganisaties
massa organisatie=massaorganisatie
navigatie oplossingen=navigatieoplossingen
niveau advies=niveauadvies
media opleiding=mediaopleiding
milieu econoom=milieueconoom
milieu overtreding=milieuovertreding
morse alfabet=morsealfabet
service artikelen=serviceartikelen
inhalatie allergie=inhalatieallergie
immigratie ambtenaren=immigratieambtenaren
communicatie opdracht=communicatieopdracht
sequentie analyse=sequentieanalyse
prestatie afhankelijk=prestatieafhankelijk
hygi[ëne artikelen=hygi[ëneartikelen
retro activiteit=retroactiviteit
trapeze artiesten=trapezeartiesten
video advertentie=videoadvertentie
schade adviseurs=schadeadviseurs
schade ontwikkeling=schadeontwikkeling
selectie opdracht=selectieopdracht
simulatie oefeningen=simulatieoefeningen
renovatie object=renovatieobject
stabilisatie oefeningen=stabilisatieoefeningen
informatie organisatie=informatieorganisatie
geboorte ouders=geboorteouders
jungle omgeving=jungleomgeving
introductie avonden=introductieavonden
cellulose acetaat=celluloseacetaat
live opnamen=liveopnamen
gedachte oefening=gedachteoefening
asperge ambassadeur=aspergeambassadeur
lui as=luias
informatie adviseur=informatieadviseur
semi openbare=semiopenbare
innovatie advies=innovatieadvies
inspectie apparatuur=inspectieapparatuur
instructie avonden=instructieavonden
isolatie afdeling=isolatieafdeling
octrooi aanvrager=octrooiaanvrager
olie afscheiding=olieafscheiding
website analyse=websiteanalyse
informatie ochtenden=informatieochtenden
relatie onderhoud=relatieonderhoud
douane autoriteit=douaneautoriteit
associatie akkoorden=associatieakkoorden
klei animaties=kleianimaties
frequentie afhankelijke=frequentieafhankelijke
industrie afval=industrieafval
micro analyse=microanalyse
derogatie aanvraag=derogatieaanvraag
convectie oven=convectieoven
cadeau opties=cadeauopties
vreugde olie=vreugdeolie
lease object=leaseobject
citronella olie=citronellaolie
software architect=softwarearchitect
vakantie ouder=vakantieouder
valuta opties=valutaopties
herrie optocht=herrieoptocht
politie overheden=politieoverheden
prestatie achterstand=prestatieachterstand
promo actie=promoactie
mini opslag=miniopslag
detectie afstand=detectieafstand
risico afstand=risicoafstand
preventie aanbod=preventieaanbod
energie agenda=energieagenda
organisatie adviezen=organisatieadviezen
warmte opbouw=warmteopbouw
zee alsem=zeealsem
intra orale=intraorale
preventie ambtenaar=preventieambtenaar
college aantekeningen=collegeaantekeningen
compensatie orders=compensatieorders
homo activist=homoactivist
politie archieven=politiearchieven
controle omgeving=controleomgeving
regio avonden=regioavonden
homo activisten=homoactivisten
horeca opleidingen=horecaopleidingen
lingerie ontwerpster=lingerieontwerpster
marine oefening=marineoefening
obligatie aankopen=obligatieaankopen
generatie armoede=generatiearmoede
ruimte overschot=ruimteoverschot
declaratie overzicht=declaratieoverzicht
mee ouder=meeouder
zee officieren=zeeofficieren
mode avond=modeavond
milieu autoriteit=milieuautoriteit
communicatie omgeving=communicatieomgeving
geboorte album=geboortealbum
service adviseur=serviceadviseur
graffiti artiest=graffitiartiest
regio archeoloog=regioarcheoloog
warmte accumulatie=warmteaccumulatie
continu arbeid=continuarbeid
spionage apparatuur=spionageapparatuur
scheeps vaart=scheepsvaart
calculatie afdeling=calculatieafdeling
service appartementen=serviceappartementen
video auto=videoauto
live opname=liveopname
metro abonnement=metroabonnement
constructie afdeling=constructieafdeling
recreatie objecten=recreatieobjecten
principe afspraak=principeafspraak
tele objectieven=teleobjectieven
zombie achtige=zombieachtige
bureau omgeving=bureauomgeving
milieu emissies=milieuemissies
milieu effectiviteit=milieueffectiviteit
locatie adres=locatieadres
subsidie orgaan=subsidieorgaan
octrooi aanvragers=octrooiaanvragers
sekse onderscheid=sekseonderscheid
software agent=softwareagent
observatie opdracht=observatieopdracht
adoptie aanvraag=adoptieaanvraag
vakantie aanvraag=vakantieaanvraag
diepte analyses=diepteanalyses
reparatie order=reparatieorder
route aanpassing=routeaanpassing
bridge avondje=bridgeavondje
lymfe oedeem=lymfeoedeem
ziekte ontwikkeling=ziekteontwikkeling
college akkoorden=collegeakkoorden
ere ambten=ereambten
communicatie aspecten=communicatieaspecten
piano akkoorden=pianoakkoorden
preventie assistent=preventieassistent
tralie afstand=tralieafstand
principe afspraken=principeafspraken
controle apparaten=controleapparaten
campagne organisatie=campagneorganisatie
koffie actie=koffieactie
douane agent=douaneagent
milieu ontwikkelingen=milieuontwikkelingen
carrière optie=carrièreoptie
introductie actie=introductieactie
coördinatie overleg=coördinatieoverleg
sushi azijn=sushiazijn
site ontwerp=siteontwerp
foto albumpje=fotoalbumpje
positie afhankelijke=positieafhankelijke
cassatie advocaten=cassatieadvocaten
camera observatie=cameraobservatie
missie activiteiten=missieactiviteiten
prestatie analyse=prestatieanalyse
torsie assen=torsieassen
montage aanwijzingen=montageaanwijzingen
observatie opdrachten=observatieopdrachten
politie opleidingen=politieopleidingen
foto afdruk=fotoafdruk
therapie aanbod=therapieaanbod
controle orgaan=controleorgaan
echo apparaat=echoapparaat
pro fijt=profijt
disco avond=discoavond
promotie actie=promotieactie
informatie architectuur=informatiearchitectuur
conversatie analyse=conversatieanalyse
espresso apparaat=espressoapparaat
volume aandeel=volumeaandeel
restauratie object=restauratieobject
discussie avonden=discussieavonden
bain marie=bain-marie
detectie apparaat=detectieapparaat
distributie organisatie=distributieorganisatie
consultatie avonden=consultatieavonden
controle organisaties=controleorganisaties
po[ëzie opvatting=po[ëzieopvatting
televisie actie=televisieactie
yoga oefening=yogaoefening
recreatie artikelen=recreatieartikelen
serie opnamen=serieopnamen
revalidatie oefeningen=revalidatieoefeningen
fusie afspraken=fusieafspraken
compressie ontsteking=compressieontsteking
rente aanbiedingen=renteaanbiedingen
overname activiteit=overnameactiviteit
media ondersteuning=mediaondersteuning
referentie architecturen=referentiearchitecturen
premie afdrachten=premieafdrachten
politie afzetting=politieafzetting
live optredens=liveoptredens
politie acties=politieacties
branche oplossing=brancheoplossing
website optimalisatie=websiteoptimalisatie
lente avonden=lenteavonden
cyste aaltjes=cysteaaltjes
ruimte object=ruimteobject
transitie agenda=transitieagenda
volume ontwikkelingen=volumeontwikkelingen
groente abonnement=groenteabonnement
milieu experten=milieuexperten
elektro aandrijving=elektroaandrijving
actie aanbiedingen=actieaanbiedingen
game ontwikkeling=gameontwikkeling
genie officier=genieofficier
audio aansluiting=audioaansluiting
politie ondersteuning=politieondersteuning
politie overleg=politieoverleg
transitie akkoord=transitieakkoord
branche opleiding=brancheopleiding
reclame ontwerper=reclameontwerper
opname apparaten=opnameapparaten
politie academies=politieacademies
keuze abonnement=keuzeabonnement
concurrentie analyse=concurrentieanalyse
methode ontwikkeling=methodeontwikkeling
controle organismen=controleorganismen
volume opbouw=volumeopbouw
pro activiteit=proactiviteit
transitie opgave=transitieopgave
lente opruiming=lenteopruiming
milieu educatief=milieueducatief
milieu opvoeding=milieuopvoeding
milieu opleidingen=milieuopleidingen
hernia operaties=herniaoperaties
keuze activiteiten=keuzeactiviteiten
zonne olie=zonneolie
immigratie ambtenaar=immigratieambtenaar
precisie aanvallen=precisieaanvallen
televisie antenne=televisieantenne
zone alarm=zonealarm
justitie assistente=justitieassistente
innovatie ontwikkeling=innovatieontwikkeling
keuze architectuur=keuzearchitectuur
tempo aanduidingen=tempoaanduidingen
reflectie opdracht=reflectieopdracht
carrière avond=carrièreavond
energie analist=energieanalist
douche arm=douchearm
genre aanduiding=genreaanduiding
energie ambitie=energieambitie
energie oefeningen=energieoefeningen
euro ambtenaren=euroambtenaren
frequentie analyse=frequentieanalyse
fusie organisaties=fusieorganisaties
thee aanbod=theeaanbod
urine analyse=urineanalyse
foto agenda=fotoagenda
isolatie oplossingen=isolatieoplossingen
infanterie aanval=infanterieaanval
energie aspecten=energieaspecten
gemeente overheden=gemeenteoverheden
keuze opdrachten=keuzeopdrachten
groente abonnementen=groenteabonnementen
media ontwikkeling=mediaontwikkeling
metro aanslag=metroaanslag
campagne avonden=campagneavonden
elektro auto's=elektroauto's
milieu oplossingen=milieuoplossingen
expansie orgaan=expansieorgaan
educatie activiteiten=educatieactiviteiten
college aanbod=collegeaanbod
familie avonden=familieavonden
informatica opleiding=informaticaopleiding
confectie ateliers=confectieateliers
geboorte attest=geboorteattest
communicatie opdrachten=communicatieopdrachten
zonne oven=zonneoven
expressie activiteiten=expressieactiviteiten
ski opleiding=skiopleiding
familie avontuur=familieavontuur
holte ontstekingen=holteontstekingen
hoogte aanduiding=hoogteaanduiding
horeca overlast=horecaoverlast
urine afscheiding=urineafscheiding
koffie assortiment=koffieassortiment
volume afname=volumeafname
evangelisatie actie=evangelisatieactie
foto avond=fotoavond
milieu actie=milieuactie
vanille achtige=vanilleachtige
mini uitvoering=miniuitvoering
balletje balletje=balletjeballetje
recherche afdeling=rechercheafdeling
osmose apparaat=osmoseapparaat
referentie object=referentieobject
concessie aanvraag=concessieaanvraag
productie overschotten=productieoverschotten
aarde aansluiting=aardeaansluiting
route opdracht=routeopdracht
auto adapter=autoadapter
gemeente activiteiten=gemeenteactiviteiten
auto aanbod=autoaanbod
stage afdeling=stageafdeling
race overalls=raceoveralls
doe activiteiten=doeactiviteiten
lente ontbijt=lenteontbijt
open minded=openminded
glucose opname=glucoseopname
de zelfde=dezelfde
organisatie opbouw=organisatieopbouw
adoptie ambtenaar=adoptieambtenaar
controle autoriteiten=controleautoriteiten
productie afname=productieafname
cassatie advies=cassatieadvies
vakantie object=vakantieobject
rogge akker=roggeakker
politie aangifte=politieaangifte
recreatie ontwikkeling=recreatieontwikkeling
recreatie oorden=recreatieoorden
taxatie opdrachten=taxatieopdrachten
wel kome=welkome
politie assistentie=politieassistentie
risico afstanden=risicoafstanden
productie apparaten=productieapparaten
projectie afstand=projectieafstand
opera orkest=operaorkest
luxe auto=luxeauto
migratie overschot=migratieoverschot
machine ontwerp=machineontwerp
media opslag=mediaopslag
productie arbeider=productiearbeider
omgeluksgetal=ongeluksgetal
makroonie=macaroni
numer=nummer
nuw=nieuw|nu
og=oog|och
ogtent=ochtend
okaars=elkaars
oke=oké
wau=wilde
lugt=lucht
omkleede=omkleden|omkleedde
kaamertje=kamertje
luste=lusten|lustte
treke=trekken
sirkusse=circussen
ookee=oké
warom=waarom
ooma=oma
wandele=wandelen
nue=nu|nee
kijke=kijken
nua=nou|nu
klaa=klaar
neeme=nemen|neem|neme
juigt=juicht
meschie=misschien
koomen=komen
nagjes=nachtjes
macademia=macadamia
kijgen=krijgen
kindere=kinderen
kruken=krukken|kruiken
klup=club
sit=zit
klure=kleur|kleuren
klurplaat=kleurplaat
kniken=knikken
knufel=knuffel
kokmt=komt
mbt=m.b.t.
woon/werkverkeer=woon-werkverkeer	gelijkwaardige begrippen koppelt u met een koppelteken.
noodig=nodig
teekening=tekening
browser-plugin=browserplug-in
weeten=weten
typjes=types|typetjes
kleet=kleed
boofe=boven
vlgs=volgens
wannabees=wannabe's
ontrekken=onttrekken
groffe=grove|grofte
adhv=ADHD|adv|a.d.h.v.
buienrader=buienradar|Buienradar
doorstuurd=doorstuurt
sorie=sorry
sie=zie
low-budget=AOW-budget
tbv=t.b.v.
veeel=veel
idd=inderdaad
bvb=bijvoorbeeld|bijv.
vernaggeld=vernacheld
quartz=kwarts
jiugen=jongen
osteopatische=osteopathische
middenoosten=Midden-Oosten
mocca=mokka
burka's=boerka's
gwn=gewoon
heele=hele
ooferal=overal
beluga's=beloega's
okay=oké
copy=kopie|kopij
vleesspiezen=vleesspiesen
euri=euro's
slaapen=slapen
laatse=laatste
mooije=mooie
aangeprijsd=aangeprezen
woon-/werkverkeer=woon-werkverkeer
laaste=laatste
signaal-/ruisverhoudingen=signaal-ruisverhoudingen
loupe=loep
citoscore=Cito-score
emailcontact=e-mailcontact|mailcontact
gebotvierd=botgevierd
word-bestand=Wordbestand
eeen=een
cruist=cruiset
buro=bureau
d'r=daar|haar
vastgetaped=vastgetapet
seep=zeep
morge=morgen
kaamer=kamer
kwa=qua
uitgepluisd=uitgeplozen
koo=ook
moeber=moeder
kiesen=kiezen
jau=jou|jouw
mooge=mogen|moge
vliegvlug=vliegensvlug
aub=a.u.b.
mir=meer|Mir
tov=t.o.v.
si=zie|is
telur=teleur
mijsje=meisje
naadenken=nadenken
naa=aan|na
geëikte=geijkte
ooja=ohja
jasen=jassen
srikt=schrikt
weeken=weken
koome=komen
tereg=terug
trugkomt=terugkomt
welteruste=welterusten
sirkes=circus
ff=even
cq=c.q.
zn=z'n|zijn
boutique=boetiek
tesaam=samen
parasympatisch=parasympathisch
ergenis=ergernis
paté's=patés
zoiezo=sowieso
speelen=spelen
teelefoon=telefoon
sprinen=springen|sprinten
poolietsie=politie
revu=revue|Reve
sheiks=sjeiks
honde=honden
booterham=boterham
boove=boven
borde=borden
selfde=zelfde
horet=hoort
jone=jongen|jonge
tog=toch
wer=ver
wagt=wacht
burde=boerde
poetse=poetsen
trugkoome=terugkomen
hooftstuk=hoofdstuk
eete=eten
jeulie=jullie
pjama=pyjama
pjaama=pyjama
seg=zeg|
gesien=gezien
naame=naam|name
huie=huilen
sodium=natrium
mesgie=misschien
miselijk=misselijk
Fryslân=Friesland
makat=maakt
tru=trui
waater=water
mar=maar
sei=zij|zei
pinderkaas=pindakaas
piletje=pilletje
pieraaten=piraten
petat=patat
paken=pakken|parken
sat=zat
schopen=schoppen
sielig=zielig
oover=over
vor=voor
prinsesenijsje=prinsessenijsje
salefje=zalfje
efa=even|eva
nau=nou|nauw
enof=en/of
bloeme=bloemen
heelemaal=helemaal
footoo=foto
mss=misschien
iig=i.i.g.
Rabo=Rabobank
bleg=beleg
aaregt=aanrecht
dankje-wel=dankjewel
scheeps-bel=scheepsbel
droogen=drogen|droge
doot=boot|dood
blau=blauw
dinetje=dingetje|dinertje
scheeps-bar=scheepsbar
durt=duurt
scheeps-bemanning=scheepsbemanning
scheeps-bemanningen=scheepsbemanningen
scheeps-arts=scheepsarts
aape=apen
beneede=beneden
bele=bellen
fandaag=vandaag
here=heer
aleen=allen|alleen
afonteuren=avonturen
balkonnen=balkons
depressiva=antidepressiva
geeneen=geen|geeneens
limoenamandelcake=limoen-amandelcake
feel=veel
barbecuen=barbecueën
droomen=dromen
dagt=dacht
scheeps-benodigdheden=scheepsbenodigdheden
blaue=blauwe
blaatjes=blaadjes
agteraan=achteraan
scheeps-afvalstoffen=scheepsafvalstoffen
besoek=bezoek
benkt=denkt
potassium=kalium
eeten=eten
duuren=buren|duren
afstant=afstand|afstamt
dankje=dank je
aaan=aan
wir=weer
kunen=kunnen
speele=spellen|spelen
sijn=zijn
kuuken=keuken|kuiken
teegen=tegen
tau=touw
liefelings=lievelings
sijm=zijn
sij=ijs|zij
spele=spelen|speel
liefelins=lievelings
siet=ziet
taafel=tafel
teelefiesie=televisie
teelefeesiekijken=televisiekijken
teekent=tekent
siten=zitten
sprinkt=springt
sjips=chips
soomaar=zomaar
oopen=open
tande=tanden
teekenen=tekenen
maaken=maken
maake=maken
afonteete=avondeten
maaar=maar
maa=maar|ma
tampesta=tandpasta
mn=mijn|m'n|m.n.
wakermaken=wakkermaken
lesen=lessen
leker=lekker
leesen=lezen|lessen
leese=lezen|lessen
lant=lang|land
lansaam=langzaam
kwartie=kwartier
kwaame=kwamen
foliën=folie|folies|fooien|oliën|folden|folie-
swemen=zwemmen
siek=ziek
hanten=handen|
so=zo
sliepa=sliep|sliepen
slape=slapen
slaape=slapen
pookiemon=Pokémon
procesverbalen=proces-verbalen|processen-verbaal
bootera=boterham
begonen=begonnen
roontjes=rondjes
soo=zo
rooje=rode|rooie
wagten=wachten
rene=rennen|René
reesauto=raceauto
proobirt=probeert
praaten=praten|praatten
schirschuim=scheerschuim
siekenhuis=ziekenhuis
soekt=zoekt
tijt=tijd
speronge=sprongen
waare=ware|waren
sweme=zwemmen
sulen=zullen
strks=straks|sterks
stome=stomme|stomen
stoele=stoelen
sterak=sterk
sroken=schrokken
uitlegen=uitleggen
ut=uit|het
loopen=lopen
oofer=over|offer
stijle=steile
bloemenwinkol=bloemenwinkel
ooke=oké
oofergeefen=overgeven
kelom=klom|kolom
oopa=opa
ligen=liggen|liegen
onlosmakend=onlosmakelijk
copy/paste=copy-paste	gelijkwaardige begrippen koppelt u met een koppelteken.
bibob=bebop
jonden=konden|joden|gunden
housing=huisvesting
temen=termen
gevatten=gevatte
beruchten=berichten|beruchte
gerichten=gerichte|geruchten
mansen=mensen
blot=bot|bloot
jont=joint|gunt
gesloot=gesloten
ongezet=omgezet
rink=drink
reest=racet
narde=harde
gereid=bereid|gereed
vosten=vorsten
heest=heerst
henen=heen
getaakt=gestaakt
heep=heel
gegrijp=begrijp
loken=lokken|koken
hord=bord|hort|hors
gord=goed|gort
kopst=kost
gedoelde=bedoelde
toept=roept
raren=rare
geiden=gelden
verblijt=verblijft
doren=doorn
vouten=fouten
paarsen=paarse
voord=voor
verliezingen=verkiezingen
verliezing=verlies|verkiezing
taakt=taak|staakt
veest=feest
uitspuitend=uitsluitend
gewaard=bewaard|gewaardeerd|gewaar
meerders=meerdere
fieren=vieren
boelen=boeken|Boelen
hoert=hoort
nart=hart|naar
peg=pech
lort=kort|lord|port|mort
volten=volgen
naak=naar|naakt
noop=hoop
lanter=later
reit=rijt|rijdt
voorkopen=voorkomen|verkopen
gelink=gelijk|gelinkt
popen=lopen
geide=beide
opstandigheden=omstandigheden
warde=waarde
jout=jou|hout
veelden=beelden
gevaat=gevaar
tonde=ronde
vost=vorst
greed=hebzucht
gezon=gezond|gazon
indrum=indruk
laver=klaver
geelden=geleden
gehouw=gebouw
smaal=smaak
hanken=banken
loever=liever
ducht=dicht
docht=dicht|doch
verzie=versie
geperkt=beperkt
zieren=sieren
boste=beboste|botste
gepaald=bepaald
singers/songwriters=singers-songwriters	gelijkwaardige begrippen koppelt u met een koppelteken.
eigenaar/bewoner=eigenaar-bewoner	gelijkwaardige begrippen koppelt u met een koppelteken.
rood/groen=rood-groen	gelijkwaardige begrippen koppelt u met een koppelteken.
rood/roze=rood-roze	gelijkwaardige begrippen koppelt u met een koppelteken.
wasmachine/droger=wasmachine-droger	gelijkwaardige begrippen koppelt u met een koppelteken.
groen/blauwe=groen-blauwe	gelijkwaardige begrippen koppelt u met een koppelteken.
buurman/vrouw=buurman of -vrouw
gitarist/zanger=gitarist-zanger	gelijkwaardige begrippen koppelt u met een koppelteken.
singer/songwriter=singer-songwriter	gelijkwaardige begrippen koppelt u met een koppelteken.
zwart/grijs=zwart-grijs	gelijkwaardige begrippen koppelt u met een koppelteken.
singer/songwriters=singer-songwriters	gelijkwaardige begrippen koppelt u met een koppelteken.
wit/zwart=wit-zwart	gelijkwaardige begrippen koppelt u met een koppelteken.
woon/slaapkamer=woon-slaapkamer	gelijkwaardige begrippen koppelt u met een koppelteken.
woon/eetkamer=woon-eetkamer	gelijkwaardige begrippen koppelt u met een koppelteken.
geel/groen=geel-groen	gelijkwaardige begrippen koppelt u met een koppelteken.
koel/vriescombinatie=koel-vriescombinatie	gelijkwaardige begrippen koppelt u met een koppelteken.
blauw/groene=blauw-groene	gelijkwaardige begrippen koppelt u met een koppelteken.
rood/zwart=rood-zwart	gelijkwaardige begrippen koppelt u met een koppelteken.
eigenaar/verhuurder=eigenaar-verhuurder	gelijkwaardige begrippen koppelt u met een koppelteken.
blauw/witte=blauw-witte	gelijkwaardige begrippen koppelt u met een koppelteken.
hem/haar=hem of haar
scheeps-agenten=scheepsagenten
zwade=zware	Een zwade is een strook gemaaid gras of graan; dat bedoelt uw waarschijnlijk niet.
afweet=af weet
scénes=scènes|scenes	Hier hoort een 'accent achterover' (accent grave) op voor de uitspraak 'sehnes', en geen voor 'siens'.
scéne=scène|scene	Hier hoort een 'accent achterover' (accent grave) op voor de uitspraak 'sehne', en geen voor 'sien'.
wamt=want
beton/gietijzer=beton- of gietijzer
zijn/haar=zijn of haar
koers/winstverhouding=koers-winstverhouding	gelijkwaardige begrippen koppelt u met een koppelteken.
ouders/verzorgers=ouders of verzorgers
hij/zij=hij of zij
rood/bruin=rood-bruin	gelijkwaardige begrippen koppelt u met een koppelteken.
rood/bruine=rood-bruine	gelijkwaardige begrippen koppelt u met een koppelteken.
blauw/groen=blauw-groen	gelijkwaardige begrippen koppelt u met een koppelteken.
oranje/rode=oranje-rode	gelijkwaardige begrippen koppelt u met een koppelteken.
gastvrouw/heer=gastvrouw of -heer
bar/restaurant=bar-restaurant	gelijkwaardige begrippen koppelt u met een koppelteken.
geel/groene=geel-groene	gelijkwaardige begrippen koppelt u met een koppelteken.
wont=wond|woont|wint
loeten=moeten
getaalde=betaalde
kirs=kies|Kirsten
koes=koeien|kus
voorkopende=voorkomende
guren=geuren
genaakte=gemaakte
mieten=moeten
rong=rond
uitgeboerd=uitgevoerd
winken=winkel
gepak=gepakt
taakte=taak te|staakte
gewens=gewend|gewenst
bren=breng|brem
geut=goot
veur=voor
geduchten=geduchte
ergen=ergens|erger
eigenaar/beheerder=eigenaar-beheerder	gelijkwaardige begrippen koppelt u met een koppelteken.
gastheer/gastvrouw=gastheer of gastvrouw
groen/gele=groen-gele	gelijkwaardige begrippen koppelt u met een koppelteken.
aan/uitknop=aan-uitknop	gelijkwaardige begrippen koppelt u met een koppelteken.
rood/oranje=rood-oranje	gelijkwaardige begrippen koppelt u met een koppelteken.
café/restaurant=café-restaurant	gelijkwaardige begrippen koppelt u met een koppelteken.
eigenaar/gebruiker=eigenaar-gebruiker	gelijkwaardige begrippen koppelt u met een koppelteken.
hotel/restaurant=hotel-restaurant	gelijkwaardige begrippen koppelt u met een koppelteken.
zender/ontvanger=zender-ontvanger	gelijkwaardige begrippen koppelt u met een koppelteken.
eigenaar/houder=eigenaar-houder	gelijkwaardige begrippen koppelt u met een koppelteken.
paan=baan|pan
trainers/coaches=trainers-coaches	gelijkwaardige begrippen koppelt u met een koppelteken.
producent/exporteur=producent-exporteur	gelijkwaardige begrippen koppelt u met een koppelteken.
gastheer/vrouw=gastheer of -vrouw
trainer/coach=trainer-coach	gelijkwaardige begrippen koppelt u met een koppelteken.
directeur/bestuurder=directeur-bestuurder	gelijkwaardige begrippen koppelt u met een koppelteken.
twee/derde=twee derde
kusttentoonstelling=kunsttentoonstelling
sten=stem
gepaalde=bepaalde
technology=technologie
ahv=a.h.v.
bza=b.z.a.
bvd=b.v.d.
blew=b.l.e.w.
bgg=b.g.g.
bd=b.d.
am=a.m.
ahw=a.h.w.
agv=a.g.v.
dd=d.d.
ZKM=Z.K.M.
ZKH=Z.K.H.
St-Jacobiparochie=St.-Jacobiparochie
St-Annaparochie=St.-Annaparochie
RIP=R.I.P.
OB=O.B.
NN=N.N.
cod=c.o.d.
dwz=d.w.z.
LS=L.S.
icm=i.c.m.
iov=i.o.v.
iom=i.o.m.
io=i.o.
ihkv=i.h.k.v.
ihb=i.h.b.
iha=i.h.a.
igv=i.g.v.
ic=i.c.
dz=d.z.
ibv=i.b.v.
fob=f.o.b.
ev=e.v.
eea=e.e.a.
edm=e.d.m.
ea=e.a.
drs-titel=drs.-titel
NB=N.B.
HM=H.M.
ism=i.s.m.
communities=community's	Als je een woord als Nederlands gebruikt, hoort het ook als Nederlands verbogen.
forste=forse
responsive=responsief|responsie|responsieve
stuklijst=stukslijst
burkini=boerkini
kunstof=kunststof
bass=bas
mischien=misschien
beluga=beloega
predikaat=predikant|predicaat
mesen=messen
gevraagt=gevraagd|gedraagt|bevraagt|gevraag
niét=niet|níét
uitgepluist=uitgeplozen
signaal/ruisverhoudingen=signaal-ruisverhoudingen
mesgien=misschien
citoscores=Cito-scores
alszijnde=als
katerns=katernen
HKM=H.K.M.
onspannende=ontspannende|niet spannende|saaie	Waarschijnlijk een vergissing
HKH=H.K.H.
AOC=A.O.C.
242-omroepen=2.42-omroepen
242-omroep=2.42-omroep
danzou=dan zou
rechtevenredige=recht evenredige
rechtevenredig=recht evenredig
onspannend=ontspannend|niet spannend|saai	Waarschijnlijk een vergissing
straciatella=stracciatella
ens=eens	Grote kans dat u met ens geen emmer bedoelt.
veeleerder=veel eerder
mvg=m.v.g.
geëikt=geijkt
accoord=akkoord
chiq=chic|chique
dalijk=dadelijk
iplv=i.pl.v.
itt=i.t.t.
belend=belendend|belendende|bedelend|bedelende
vlnr=v.l.n.r.
wb=w.b.
vwb=v.w.b.
vvtt=v.v.t.t.
vvt=v.v.t.
vv=v.v.
vtt=v.t.t.
vrnl=v.r.n.l.
vh=v.h.
wo=w.o.
vd=v.d.
vC=v.C.
tzt=t.z.t.
twv=t.w.v.
tw=t.w.
tnv=t.n.v.
tlv=t.l.v.
wns=w.n.s.
wvttk=w.v.t.t.k.
tk=t.k.
zsm=z.s.m.
pooi=mooi|prooi
naren=nare
genaakt=gemaakt
heef=heeft
nebben=hebben
heven=hoeven|geven
aantap=aantal
zpl=z.pl.
zg=z.g.
zp=z.p.
zoz=z.o.z.
zkm=z.k.m.
zj=zij|z.j.
zi=zij|z.i.
zgoh=z.g.o.h.
zgan=z.g.a.n.
tka=t.k.a.
thv=t.h.v.
izgst=i.z.g.st.
notk=n.o.t.k.
olv=o.l.v.
oi=o.i.
ogv=o.g.v.
oer=o.e.r.
obv=o.b.v.
oa=o.a.
nvt=n.v.t.
nav=n.a.v.
ottt=o.t.t.t.
muv=m.u.v.
mmv=m.m.v.
miv=m.i.v.
mbv=m.b.v.
maw=m.a.w.
lc=l.c.
kk=k.k.
ott=o.t.t.
ovt=o.v.t.
tht=t.h.t.
sl=s.l.
tha=t.h.a.
th=t.h.
tgv=t.g.v.
tem=t.e.m.
tav=t.a.v.
spa-leden=sp.a-leden
svp=s.v.p.
sj=s.j.
ovtt=o.v.t.t.
qq=q.q.
qed=q.e.d.
pw=p.w.
pppn=p.p.p.n.
pp=p.p.
po=p.o.
pm=p.m.
ovv=o.v.v.
alemaal=allemaal
seloopen=ze lopen
ale=alle|al|alen
koudwater=koud water
allertijden=aller tijden
inorde=in orde
vanhet=van het
nouja=nou ja
opensource=open source
smiddags='s middags
thuisvoelen=thuis voelen
kortgeding=kort geding
stagelopen=stage lopen
langsgeweest=langs geweest
must-haves=must haves
meehouden=mee houden
stilletjesaan=stilletjes aan
nietmeer=niet meer
werk-privé=werk privé
geefem=geef hem
hebbie=heeft hij	Dit is spreektaal.
kan-ie=kan hij	Dit is spreektaal.
erook=er ook	Dit is spreektaal.
hetelucht=hete lucht
perongeluk=per ongeluk
geitenwollensokken=geitenwollen sokken
zonodig=zo nodig
last-minute=last minute
zorgdragen=zorg dragen
daarbijhorende=daarbij horende
maarja=maar ja
zoniet=zo niet
zometeen=zo meteen
vantevoren=van tevoren
etcetera=et cetera
temidden=te midden
full-colour=full colour
weldegelijk=wel degelijk
alledrie=alle drie
is-ie=is hij	Dit is spreektaal.
joint-venture=joint venture
verderwerken=verder werken
achterkomen=achter komen
musthave=must have
nogsteeds=nog steeds
optijd=op tijd
heeft-ie=heeft hij	Dit is spreektaal.
jammergenoeg=jammer genoeg
voorelkaar=voor elkaar
alombekende=alom bekende
bijzeggen=bij zeggen
omdat-ie=omdat hij	Dit is spreektaal.
heefter=heeft er
geburter=gebeurt er
alterego=alter ego
gaanar=ga naar
savonds='s avonds
zodadelijk=zo dadelijk
rechttoe-rechtaan=rechttoe rechtaan
overtijd=over tijd
nogwat=nog wat
onverrichterzake=onverrichter zake
verweg=ver weg
totaan=tot aan
lowbudget=low budget
bijgedaan=bij gedaan
picobello=pico bello
platdak=plat dak
evenhoog=even hoog
opuit=op uit
tever=te ver
verkeerdom=verkeerd om
hoelaat=hoe laat
langetijd=lange tijd
alswel=als wel
full-color=full colour
zogoed=zo goed
meerbepaald=meer bepaald
tegaan=te gaan
terzelfdertijd=tezelfdertijd|terzelfder tijd
terplaatse=ter plaatse
vrijetijd=vrije tijd
hardeschijf=harde schijf
aande=aan de
inhet=in het
ofdat=of|of dat
dondersgoed=donders goed
af-fabriek=af fabriek
sindskort=sinds kort
doorelkaar=door elkaar
driekwartier=drie kwartier
ensuite=en suite
eerlijkgezegd=eerlijk gezegd
lastminutes=last minutes
thuisvoel=thuis voel
overde=over de
splitscreen=split screen
tezijn=te zijn
ex-libris=ex libris
anderhalfuur=anderhalf uur
collectorsitem=collector's item
's-middags='s middags
voormij=voor mij
's-winters='s winters
hocus-pocus=hocus pocus
afgeweest=af geweest
uitgeweest=uit geweest
vakantievieren=vakantie vieren
gaanse=gaan ze
maarliefst=maar liefst
civielrecht=civiel recht
iedergeval=ieder geval
gaamaar=ga maar
bijelkaar=bij elkaar
zondermeer=zonder meer
ondermeer=onder meer
tweederde=twee derde
multiple-choice=multiple choice
's-morgens='s morgens
uithanden=uit handen
ofso=of zo
thuisvoelt=thuis voelt
kunenwe=kunnen we
langetermijn=lange termijn
verledentijd=verleden tijd
jongsaf=jongs af
inelkaar=in elkaar
hoevaak=hoe vaak
maargoed=maar goed
volgas=vol gas
alsvolgt=als volgt
en-suite=en suite
terwille=ter wille
zegmaar=zeg maar
ofzoiets=of zoiets
goedzo=goed zo
da's=dat is
terzake=ter zake
tijdschrijft=tijdschrift|tijd schrijft
teruggeweest=terug geweest
nieteens=niet eens
's-nachts='s nachts
vandien=van dien
tewerk=te werk
must-have=must have
notabene=nota bene
opweg=op weg
ookwel=ook wel
bijde=beide|bij de
lange-termijn=lange termijn
pro-deo=pro deo
fair-trade=fair trade
uitelkaar=uit elkaar
grand-café=grand café
ad-hoc=ad hoc
upperclass=upper class
opzich=op zich
bovenvernoemde=boven vernoemde
high-five=high five
beslaggenomen=beslag genomen
's-werelds='s werelds
zekerstellen=zeker stellen
deluxe=de luxe
new-age=new age
terplekke=ter plekke
last-minutes=last minutes
viavia=via via
lowcost=low cot
opendagen=open dagen
snachts='s nachts
integenstelling=in tegenstelling
vanalles=van alles
smorgens='s morgens
's-avonds='s avonds
ofzo=of zo
ingebreke=in gebreke
total-loss=total loss
eenderde=een derde
voorzover=voor zover
split-screen=split screen
ookal=ook al
hogedruk=hoge druk
dat-ie=dat hij	Dit is spreektaal.
roestvrijstaal=roestvrij staal
fairtrade=fair trade
gasgeven=gas geven
gaat-ie=gaat hij	Dit is spreektaal
temaken=te maken
hand-in-hand=hand in hand
om-en-om=om en om
inbedrijfstellen=in bedrijf stellen
video-on-demand=video on demand
oog-in-oog=oog in oog
af-en-toe=af en toe
t'is='t is|het is
op't=op 't|op het
aant=aan het|aan 't|aant.
huis-aan-huis=huis aan huis
vanvoor=van voor|van voren
just-in-time=just in time
stap-voor-stap=stap voor stap
inwerkingtreden=in werking treden
vandeweek=van de week
weetjewel=weet je wel
iniedergeval=in ieder geval
avant-la-lettre=avant la lettre
hoedanook=hoe dan ook
ééntiende= een tiende
kzal=ik zal|'k zal
kwil='k wil|ik wil
alles-in-een=alles in een
ruikenroos=ruik een roos
soodor=zo door
sijntande=zijn tanden
sooeng=zo eng
sepakt=ze pakt
semoesten=ze moesten
wordt-ie=wordt hij	Dit is spreektaal.
vrijeslag=vrije slag
zoutwater=zout water
sesijnklaar=ze zijn klaar
je-van-het=je van het
sijnerniet=zijn er niet
zegenmam=zeggen, mam|zegen, mam|
maares=maar es|maar eens
lik-op-stuk=lik op stuk
inbeslaggenomen=in beslag genomen
is't=is het|is 't
pas-de-deux=pas de deux
tone-of-voice=tone of voice
in't=in 't|in het
oid=o.i.d.|of iets dergelijks
kheb=ik heb|'k heb
sijner=zijn er
één-voor-één=een voor een
een-na-hoogste=een na hoogste
al-dan-niet=al dan niet
khad='k had|ik had
kzou='k zoe|ik zou
face-to-face=face to face
aan't=aan 't|aan het
je'm=je 'm|je hem
tzal='t zal|het zal
min-of-meer=min of meer
recht-door-zee=recht door zee
jaar-op-jaar=jaar op jaar
afentoe=af en toe
twee-en-een-half=twee en een half
twee-onder-een-kap=twee onder een kap
kvind='k vind| ik vind
state-of-the-art=modern|state of the art
out-of-the-box=out of the box
hedentendage=tegenwoordig|heden ten dage|vandaag de dag
tezijnertijd=ooit|eens|te zijner tijd|op het juiste moment
kdenk='k denk|ik denk
instandgehouden=in stand gehouden
zij-aan-zij=zij aan zij
to-the-point=tp the point
ivm=i.v.m.|in verband met
voorderest=voor de rest
alles-of-niets=alles of niets
ervanuit=er vanuit|ervan uit
ton-sur-ton=ton sur ton
door-en-door=door en door
twas='t was|het was
vant=van 't|van het
over-en-weer=over en weer
jeu-de-boules=jeu de boules
één-tegen-één=een tegen een
nek-aan-nek=nek aan nek
glas-in-lood=glas in lood
enzomeer=en zo meer
ipv=i.p.v.|in plaats van
jeweetwel=je weet wel
totstandkomen=tot stand komen
dmv=d.m.v.|door middel van
totstandgekomen=tot stand gekomen
's-zomers='s zomers
roepense=roepen ze
ex-voto's=ex voto's
toegekregen=toe gekregen
must-sees=must sees
de-facto=de facto
tussenstaat=tussen staat
toerijden=toe rijden
aupair=au pair
alter-ego's=alter ego's
meemag=mee mag
blauwbessen=blauwe bessen
honderdmiljoen=honderd miljoen
kipkerrie=kip kerrie
uitstekels=uitsteeksels|uit stekels
paarduizend=paar duizend
opeenstaande=openstaande|opeen staande
kwijtkunnen=kwijt kunnen
prijsstellen=prijs stellen
wassenbeeld=wassen beeld
blijmaken=blij maken
allevier=alle vier
ietswat=ietwat|iets wat
wegmoeten=weg moeten
aangelaten=aan gelaten
almeer=alweer|Almere|al meer|aleer|alwéér|kalmeer|Almeers|afmeer|almee|valmeer
new-wave=new wave
beslagleggen=beslag leggen
één-derde=een derde
bon-vivant=bon vivant
hocuspocus=hocus pocus
eigenmerk=eigen merk
rondenlang=ronden lang
meemogen=mee mogen
kipcurry=kip curry
bijdenken=bij denken
uitgeholpen=uit geholpen
nogeens=nog eens
jahoor=ja, hoor
recht-toe-recht-aan=rechttoe rechtaan
opwijzen=op wijzen
septictank=septic tank
wegkunnen=weg kunnen
aangeweest=aan geweest
nee-zeggen=nee zeggen
collectors-item=collector's item
danook=dan ook
beziggeweest=bezig weggeweest
seboet=ze moet
weneeme=we nemen
tussenzitten=tussen zitten
oonee=oh nee
niena=niet na|Nina
nouen=nou en
teleese=te lezen
nietIk=niet ik
seheen=ze heen
wilje=wil je
wakermaaken=wakker maken
netals=net als|netels
publiekin=publiek in
oone=oh nee
ookniet=ook niet
segingen=ze gingen
seginge=ze gingen
segan=ze gaan
segaat=ze gaat
segaan=ze gaan
sefint=ze vindt
grandslam=grand slam
thuisgevoeld=thuis gevoeld
meemoet=mee moet
septictanks=septic tanks
todo's=to do's
doorblijven=door blijven
meemoeten=mee moeten
meemocht=mee mocht
stervensduur=stervens duur
nationaalpark=nationaal park
matgezet=mat gezet
ingeholpen=in geholpen
alomgeprezen=alom geprezen
normaalgezien=normaal gezien
krijgese=krijgen ze
lagedruk=lage druk
's-lands='s lands
déja-vu=déja vu
terugkan=terug kan
a-la=à la
wereldwijdeweb=wereldwijde web
hetvolgende=het volgende
terugmoet=terug moet
luchthappen=lucht happen
zegt-ie=zegt hij	Dit is spreektaal.
drievierde=drie vierde
agter=achter
wingkel=winkel
fast=vast
fraagen=vragen
freemt=vreemd
gehaalt=gehaald
gan=gaan
gehaal=gehaald
geefte=gaf
geefen=geven
geefe=geven
hji=hij
winkols=winkels
ferfriser=verfrisser
muisen=muizen
vint=vind|vindt
waatertrapelen=watertrappelen
friendin=vriendin
wnat=want
wort=word|wordt
zegne=zeggen|zegen
forstele=voorstellen
gebeete=gebeten
frui=fruit
finden=vinden
fijf=vijf
ferasing=verrassing
huile=huilen
forleese=voorlezen
gebleefen=gebleven
autoo=auto|auto-|Auto
fraag=vraag
zlaape=slapen
fiet=fiets
halgelslag=hagelslag
fraagt=vraagt
fiesie=visie
fiele=vielen
fertelt=vertelt
fergeeten=vergeten
fer=ver
geburt=gebeurt
fegten=vechten
bine=binnen
gaa=ga
froeg=vroeg
gekoose=gekozen
ophet=op het
hetzelf=het zelf
openhaarden=open haarden
ofniet=of niet
topvijf=top vijf
grootlicht=groot licht
kortegolf=korte golf
barslecht=bar slecht
teweinig=te weinig
zolangzamerhand=zo langzamerhand
tekomen=te komen
wijdopen=wijd open
zodus=zo dus
aanvast=aan vast
uitkan=uit kan
heelveel=heel veel
twee-derde=twee derde
metde=met de
heetie=heet hij
high-tea=high tea
heenkijken=heen kijken
adhoc=ad hoc
frij=vrij
naarde=naar de
friendinetjes=vriendinnetjes
friendinetje=vriendinnetje
friendinen=vriendinnen
boofen=boven
heeten=heette, heten
doorde=door de
barslechte=bar slechte
topdrie=top drie
nuja=nu ja
not-done=not done|ongepast
dockingstation=docking station
watergeven=water geven
overland=over land
tenopzichte=ten opzichte
komop=kom op
zorggedragen=zorg gedragen
ziekmelden=ziek melden
danku=dank u
tekoop=te koop
fas=vast
gelukeg=gelukkig
was-ie=was hij	Dit is spreektaal.
ijgen=eigen
haut=hout
wilen=wielen|willen
geloopen=gelopen
hupelt=huppelt
jamer=jammer
its=iets
irste=eerste
irst=eerst
ijgelek=eigenlijk
autos=auto's
iedee=idee
bebagt=bedacht
jarloers=jaloers
ales=alles
gesigt=gezicht
geseleger=gezelliger
iede=idee
footo=foto
autoos=auto's
hat=had
mga=mag
antwort=antwoordt|antwoord
droome=dromen
afontuur=avontuur
afgeloopen=afgelopen
scheeps-agent=scheepsagent
efe=even
dur=duur
digt=dicht
duk=buk
dig=dicht
detuutert=betoeterd
moder=modder|moeder
deese=deze
dent=bent
bij-zonder=bijzonder
segt=zegt
scheeps-afval=scheepsafval
beneebe=beneden
altij=altijd
bangkje=bankje
beneeden=beneden
auder=ouder
andoen=aandoen
wert=werd
ginge=gingen
sal=zal
habe=hadden
haagelslag=hagelslag
gwoon=gewoon
gront=grond
heben=hebben
goet=goed
glat=glad
ginen=gingen
iebereen=iedereen
ztil=stil
groote=grootte|grote
moogen=mogen
hantje=handje
binen=binnen
sieken=stiekem|zieken
hept=heeft
hep=heb
werbaast=verbaast
rusie=ruzie
stofgezogen=gestofzuigd
ambulanse=ambulance
beete=beetje
altijt=altijd
falt=valt
hade=hadden
gespilt=gespeeld
hant=hand
foer=voer
beginen=beginnen
begine=beginnen
beeter=beter
beenen=benen
gevalen=gevallen
beekers=bekers
beebie=baby
bedagt=bedacht
gelukig=gelukkig
bekienie=bikini
sig=zich
bebiening=bediening
blijfen=blijven
flees=vlees|fles
opzichzelf=op zichzelf
opendeur=open deur
kindsaf=kinds af
goedkomen=goed komen
onderbehandeling=onder behandeling
dathet=dat het
zestienmeter=zestien meter
low-profile=low profile
tenkoste=ten koste
warmwater=warm water
to-do=to do
USA=VS|Verenigde Staten
tenemen=te nemen
ex-ante=ex ante
fullcolour=full colour
dieje=die je
staat-ie=staat hij	Dit is spreektaal.
of-ie=of hij	Dit is spreektaal.
teweten=te weten
onroerendgoed=onroerend goed
endat=en dat
alwel=alhoewel|al wel
aleemaar=allemaal|alleen maar
jamaar=ja maar
perdag=per dag
zoiemand=zo iemand
doeter=doet er
alszodanig=als zodanig
algesie=al gezien
ingebruik=in gebruik
wat-ie=wat hij	Dit is spreektaal.
fintem=vind hem
gaase=gaan ze
fanelkaar=van elkaar
egtwa=echt waar
denktie=denkt hij
alleenmaar=alleen maar
kunje=kun je
denkje=denk je
denkik=denk ik
naarboven=naar boven
zero-tolerance=zero tolerance
omzeep=om zeep
top-tien=top tien
voorhet=voor het
groengas=groen gas
inprincipe=in principe
oudpapier=oud papier
alter-ego=alter ego
low-cost=low cost
indeze=in deze
top-vijf=top vijf
datde=dat de
waar-ie=waar hij	Dit is spreektaal.
infeite=feitelijk|in feite
persé=per se
enzo=en zo
seniorleden=senior leden
oogspringende=oog springende
volgensmij=volgens mij
normaalgesproken=normaal gesproken
evenlang=even lang
teweer=te weer
tengevolge=ten gevolge
middenop=midden op
éénderde=een derde
's-ochtends='s ochtends
musthaves=must haves
halthouden=halt houden
eneen=en een
zovaak=zo vaak
algekogt=al gekocht
welleens=wel eens
voorzich=voor zich
nogmaar=nog maar
ofwat=of wat
hebje=heb je
alletwee=alle twee
enja=en ja
zater=zat er|zaten
enhet=en het
postpartum=post partum
alsje=als je
vrijspel=vrij spel
overna=over na
opkan=op kan
verbandhoudende=verband houdende
inverband=in verband
inbeslag=in beslag
had-ie=had hij	Dit is spreektaal.
ishet=is het
iseen=is een
au-bain-marie=au bain-marie
deste=des te
a-capella=a capella
mijnsinziens=mijns inziens
wildzwijn=wild zwijn
in-situ=in situ
voorals=vooral|voor als
ojee=o jee
blackbox=black box
handliggende=hand liggende
watvoor=wat voor
tegeven=te geven
tezien=te zien
naarbinnen=naar binnen
aantoe=aan toe
zogauw=zo gauw
vice-versa=vice versa
ofja=of ja
bijgezegd=bij gezegd
kleinbeeld=klein beeld
oud-papier=oud papier
evengroot=even groot
istie=is hij
zoeen=zo'n|zo een
beganegrond=begane grond
opelkaar=op elkaar
dusja=dus ja
instand=in stand
moet-ie=moet hij	Dit is spreektaal.
doet-ie=doet hij	Dit is spreektaal.
alombekend=alom bekend
socialmedia=social media
aldoende=al doende
tegenmoet=tegemoet|tegen moet
langebaan=lange baan
heelwat=heel wat
social-media=social media
owja=o ja
morgensvroeg=morgens vroeg
bijvoorbaat=bij voorbaat
vooreen=voor een
aanhet=aan het
ansich=an sich
tedoen=te doen
derest=de rest
eruitgehaald=eruit gehaald
veelmeer=veel meer
aanelkaar=aan elkaar
da'k=dat ik
werkelijkwaar=werkelijk waar
datie=dat hij
in-vitro=in vitro
opte=op te
inzoverre=in zoverre
apropos=à propos
vanweg=vanwege|van weg
ereen=er een
grootmoederstijd=grootmoeders tijd
erweer=er weer
heetwater=heet water
tehouden=te houden
tezeer=te zeer
aante=aan te
verderweg=verder weg
hoefte=hoefde|hoef te
doetem=doet hem
netzoals=net zoals
telaat=te laat
tenvolle=ten volle
grandcafé=grand café
ikheb=ik heb
drogestof=droge stof
weereens=weer eens
eerstelijn=eerste lijn
top-drie=top drie
tenonder=ten onder
nogwel=nog wel
netzo=net zo
achja=ach ja
a-priori=a priori
waarnodig=waar nodig
aanboord=aan boord
zomogelijk=zo mogelijk
gewaarzijn=gewaar zijn
jaarlang=jaar lang
heledag=hele dag
metname=met name
o-zo=o zo
handliggend=hand liggend
ad-interim=ad interim
openwater=open water
writersblock=writer's block
jeje=je je
openhaard=open haard
