# added postag entries
#-------------------------------------------------------------------------------
# Do not add words here, but report them to languagetool@taaltik.nl
#-------------------------------------------------------------------------------
aardappelmes	aardappelmes	ZNW:EKV:HET
backoffice	backoffice	ZNW:EKV
ereterras	ereterras	ZNW:EKV:HET
topbasketbal	topbasketbal	ZNW:EKV:HET
upbeat	upbeat	ZNW:EKV:DE_
aardling	aardling	ZNW:EKV:DE_
Kamper	Kamper	BNW:STL:ONV
Hindoepriester	Hindoepriester	ZNW:EKV:DE_
Hindoepriesters	Hindoepriester	ZNW:MRV:DE_
gebakdoos	gebakdoos	ZNW:EKV:DE_
neustong	neustong	ZNW:EKV:DE_
exploit	exploit	ZNW:EKV:DE_
gezien	gezien	VRZ
werkdip	werkdip	ZNW:EKV:DE_
aantoets	aantoets	ZNW:EKV:DE_
aantoetsen	aantoets	ZNW:MRV:DE_
uittoets	uittoets	ZNW:EKV:DE_
uittoetsen	uittoets	ZNW:MRV:DE_
aardappelmessen	aardappelmes	ZNW:MRV:DE_
aardappelpap	aardappelpap	ZNW:EKV:DE_
aardappelpapje	aardappelpap	ZNW:EKV:VRK:HET
aardbeienkwark	aardbeienkwark	ZNW:EKV:DE_
aardbeienkwarkje	aardbeienkwark	ZNW:EKV:VRK:HET
aartsvijandin	aartsvijandin	ZNW:EKV:DE_
covid	covid	ZNW:EKV
schendig	schendig	BNW:STL:ONV
schendige	schendig	BNW:STL:VRB
schendigen	schendig	BNW:STL:MRV:DE_
dourine	dourine	ZNW:EKV
honend	honend	BNW:STL:ONV
honende	honend	BNW:STL:VRB
honendst	honend	BNW:OVR:ONV
honends	honend	BNW:STL:IET
honender	honend	BNW:VGR:ONV
chemiseren	chemiseren	WKW:TGW:INF
saaierd	saaierd	ZNW:EKV:DE_
saaierds	saaierd	ZNW:MRV:DE_
exploits	exploit	ZNW:MRV:DE_
wiekstand	wiekstand	ZNW:EKV:DE_
wiekstanden	wiekstand	ZNW:MRV:DE_
smouzen	smous	ZNW:MRV:DE_
virga's	virga	ZNW:MRV:DE_
logementsschip	logementsschip	ZNW:EKV:HET
ontharding	ontharding	ZNW:MRV:DE_
luidop	luidop	BYW
alsdan	alsdan	BYW
felomstreden	felomstreden	BNW:STL:ONV
niks	niks	BYW
hollewaai	hollewaai	ZNW:EKV:DE_
orlon	orlon	ZNW:EKV:HET
pekari	pekari	ZNW:EKV:DE_
pekari's	pekari	ZNW:MRV:DE_
zonneberen	zonnebeer	ZNW:MRV:DE_
downbeat	downbeat	ZNW:EKV:DE_
downbeats	downbeat	ZNW:MRV:DE_
zetvoeg	zetvoeg	ZNW:EKV:DE_
zetvoegen	zetvoeg	ZNW:MRV:DE_
carapax	carapax	ZNW:EKV:DE_
hafiz	hafiz	ZNW:EKV:DE_
repeater	repeater	ZNW:EKV:DE_
repeaters	repeater	ZNW:MRV:DE_
rondat	rondat	ZNW:EKV:DE_
halflinnen	halflinnen	BNW:STF
14-daags	14-daags	BNW:STL:ONV
14-daagse	14-daags	BNW:STL:VRB
1-daags	1-daags	BNW:STL:ONV
1-daagse	1-daags	BNW:STL:VRB
4-daags	4-daags	BNW:STL:ONV
4-daags	4-daags	BNW:STL:VRB
5-daags	5-daags	BNW:STL:ONV
5-daagse	5-daags	BNW:STL:VRB
6-daags	6-daags	BNW:STL:ONV
6-daagse	6-daags	BNW:STL:VRB
7-daags	7-daags	BNW:STL:ONV
7-daagse	7-daags	BNW:STL:VRB
8-daags	8-daags	BNW:STL:ONV
8-daagse	8-daags	BNW:STL:VRB
9-daags	9-daags	BNW:STL:ONV
9-daagse	9-daags	BNW:STL:VRB
10-daags	10-daags	BNW:STL:ONV
10-daagse	10-daags	BNW:STL:VRB
11-daags	11-daags	BNW:STL:ONV
11-daagse	11-daags	BNW:STL:VRB
12-daags	12-daags	BNW:STL:ONV
12-daagse	12-daags	BNW:STL:VRB
13-daags	13-daags	BNW:STL:ONV
13-daagse	13-daags	BNW:STL:VRB
21-daags	21-daags	BNW:STL:ONV
21-daagse	21-daags	BNW:STL:VRB
welnee	welnee	TSW
wellnessbranche	wellnessbranche	ZNW:EKV:DE_
caroteengehalte	caroteengehalte	ZNW:EKV:HET
eerder	eerder	BNW:VGR:ONV
paardentemmer	paardentemmer	ZNW:EKV:DE_
paardentemmers	paardentemmer	ZNW:MRV:DE_
zeerus	zeerus	ZNW:EKV:DE_
azolla	azolla	ZNW:EKV:DE_
ex-missen	ex-miss	ZNW:MRV:DE_
daspin	daspin	ZNW:EKV:DE_
emocratie	emocratie	ZNW:EKV:DE_
gruiten	gruiten	WKW:TGW:INF
gruit	gruiten	WKW:TGW:1EP
